Seed	Emotion
colorato	gioia
colorata	gioia
colorate	gioia
colorati	gioia
esuberantissimo	gioia
esuberantissimi	gioia
esuberantissima	gioia
esuberante	gioia
esuberanti	gioia
esuberantissime	gioia
gaudio	gioia
gaudi	gioia
esultanza	gioia
esultanze	gioia
libera	gioia
libere	gioia
liberaccii	gioia
libero	gioia
liberino	gioia
liberaccia	gioia
liberaccio	gioia
liberosetti	gioia
liberaccie	gioia
liberini	gioia
liberosetto	gioia
liberissimi	gioia
liberissime	gioia
liberine	gioia
liberosette	gioia
liberissima	gioia
liberina	gioia
liberosetta	gioia
liberi	gioia
liberissimo	gioia
eccitato	gioia
eccitate	gioia
eccitati	gioia
eccitata	gioia
bellezza	gioia
bellezze	gioia
letizia	gioia
letizie	gioia
spensieratezze	gioia
spensieratezza	gioia
risate	gioia
risata	gioia
soddisfazioni	gioia
soddisfazione	gioia
euforico	gioia
euforica	gioia
euforici	gioia
euforiche	gioia
trionfanti	gioia
trionfante	gioia
gaiezze	gioia
gaiezza	gioia
eccitai	gioia
ecciterà	gioia
ecciti	gioia
ecciteresti	gioia
eccitava	gioia
ecciteranno	gioia
ecciterete	gioia
ecciterebbe	gioia
eccitavate	gioia
eccitassero	gioia
ecciteremmo	gioia
eccitasse	gioia
eccitassimo	gioia
eccitate	gioia
ecciterò	gioia
eccitaste	gioia
eccito	gioia
eccitino	gioia
eccitanti	gioia
eccitò	gioia
eccitando	gioia
eccita	gioia
eccitarono	gioia
eccitammo	gioia
eccitati	gioia
ecciterei	gioia
eccitiate	gioia
eccitata	gioia
eccitar	gioia
eccitare	gioia
eccitavi	gioia
eccitasti	gioia
eccitavamo	gioia
eccitato	gioia
ecciterai	gioia
ecciterebbero	gioia
eccitano	gioia
eccitereste	gioia
eccitante	gioia
eccitassi	gioia
eccitavo	gioia
ecciteremo	gioia
eccitiamo	gioia
eccitavano	gioia
cielo	gioia
cieli	gioia
esilarassimo	gioia
esilarerete	gioia
esilarammo	gioia
esilarasti	gioia
esilarai	gioia
esilareremmo	gioia
esilarerai	gioia
esilarereste	gioia
esilaraste	gioia
esilarano	gioia
esilarassero	gioia
esilaro	gioia
esilarò	gioia
esilarassi	gioia
esilaravano	gioia
esilareranno	gioia
esilariate	gioia
esilaranti	gioia
esilarava	gioia
esilarerebbero	gioia
esilarato	gioia
esilaravamo	gioia
esilarerebbe	gioia
esilareresti	gioia
esilareremo	gioia
esilaravo	gioia
esilarerà	gioia
esilarerò	gioia
esilara	gioia
esilarerei	gioia
esilaravi	gioia
esilarante	gioia
esilarati	gioia
esilarasse	gioia
esilari	gioia
esilariamo	gioia
esilaravate	gioia
esilarar	gioia
esilarando	gioia
esilarata	gioia
esilararono	gioia
esilarare	gioia
esilarate	gioia
esilarino	gioia
cantano	gioia
canterà	gioia
canti	gioia
canteresti	gioia
canterai	gioia
canteremmo	gioia
cantammo	gioia
cantasti	gioia
cantava	gioia
canterò	gioia
cantaste	gioia
cantiate	gioia
cantanti	gioia
cantai	gioia
cantiamo	gioia
cantassimo	gioia
canterei	gioia
cantarono	gioia
canterete	gioia
cantò	gioia
cantavo	gioia
cantar	gioia
cantassi	gioia
cantata	gioia
canterebbero	gioia
cantassero	gioia
cantavano	gioia
cantando	gioia
canterebbe	gioia
cantate	gioia
cantavate	gioia
cantereste	gioia
cantasse	gioia
canta	gioia
cantante	gioia
cantato	gioia
canto	gioia
canteranno	gioia
cantare	gioia
canteremo	gioia
cantavi	gioia
cantati	gioia
cantino	gioia
cantavamo	gioia
allegria	gioia
allegrie	gioia
gaiini	gioia
gaiina	gioia
gaiaccia	gioia
gaiissimo	gioia
gaiissima	gioia
gaiosetti	gioia
gaiaccii	gioia
gaiosette	gioia
gaiaccie	gioia
gaio	gioia
gaiosetto	gioia
gaiino	gioia
gaiosetta	gioia
gaia	gioia
gaiissimi	gioia
gaiaccio	gioia
gaiine	gioia
gaii	gioia
gaiissime	gioia
gaie	gioia
giubili	gioia
giubilo	gioia
contentissime	gioia
contentissimo	gioia
contentaccie	gioia
contentina	gioia
contentaccio	gioia
contentino	gioia
contentosetto	gioia
contento	gioia
contentissima	gioia
contentosetta	gioia
contenta	gioia
contentaccii	gioia
contentini	gioia
contente	gioia
contentissimi	gioia
contentaccia	gioia
contentine	gioia
contentosetti	gioia
contenti	gioia
contentosette	gioia
gioia	gioia
gioie	gioia
festosi	gioia
festoso	gioia
festosino	gioia
festosaccie	gioia
festosaccio	gioia
festose	gioia
festosissima	gioia
festosina	gioia
festosetto	gioia
festosette	gioia
festosissime	gioia
festosa	gioia
festosissimi	gioia
festosissimo	gioia
festosini	gioia
festosetti	gioia
festosaccia	gioia
festosine	gioia
festosaccii	gioia
festosetta	gioia
allegrissime	gioia
allegraccio	gioia
allegrini	gioia
allegrina	gioia
allegrosetta	gioia
allegro	gioia
allegrosette	gioia
allegrissima	gioia
allegraccie	gioia
allegrosetti	gioia
allegre	gioia
allegrino	gioia
allegrosetto	gioia
allegrissimo	gioia
allegraccii	gioia
allegrine	gioia
allegraccia	gioia
allegrissimi	gioia
allegri	gioia
allegra	gioia
giocherai	gioia
giocavo	gioia
giocaste	gioia
giochereste	gioia
giocherebbe	gioia
giocassi	gioia
giocherebbero	gioia
giocato	gioia
giocherà	gioia
giocherò	gioia
giocasse	gioia
giocare	gioia
giocava	gioia
giocassimo	gioia
giocavamo	gioia
giocavate	gioia
giocata	gioia
giocanti	gioia
giocavano	gioia
giocavi	gioia
giochi	gioia
giocante	gioia
giocate	gioia
giochiamo	gioia
giochiate	gioia
giocheremo	gioia
giocar	gioia
giocheremmo	gioia
giocheranno	gioia
giocherete	gioia
gioco	gioia
giocò	gioia
giocherei	gioia
giocano	gioia
giocai	gioia
gioca	gioia
giocheresti	gioia
giocammo	gioia
giocati	gioia
giocarono	gioia
giochino	gioia
giocasti	gioia
giocassero	gioia
giocando	gioia
serenità	gioia
giocondità	gioia
solleticherei	gioia
solleticate	gioia
solleticheremmo	gioia
solleticassi	gioia
solleticassero	gioia
solletichiate	gioia
solleticar	gioia
solleticante	gioia
solleticavi	gioia
solleticava	gioia
solleticare	gioia
solleticherete	gioia
solleticarono	gioia
solleticati	gioia
solleticherebbe	gioia
solletichereste	gioia
solleticherò	gioia
solleticata	gioia
solleticavano	gioia
solletico	gioia
solletichino	gioia
solleticato	gioia
solleticavamo	gioia
solleticheremo	gioia
solleticanti	gioia
solleticammo	gioia
solleticassimo	gioia
solleticherai	gioia
solleticaste	gioia
solleticò	gioia
solleticheresti	gioia
solleticavo	gioia
solleticherà	gioia
solleticano	gioia
solleticavate	gioia
solletichi	gioia
solleticasse	gioia
solleticheranno	gioia
solleticai	gioia
solleticando	gioia
solletichiamo	gioia
solleticherebbero	gioia
solleticasti	gioia
solletica	gioia
deliziati	gioia
deliziata	gioia
deliziato	gioia
deliziate	gioia
appagati	gioia
appagata	gioia
appagate	gioia
appagato	gioia
condivider	gioia
condivisa	gioia
condiviso	gioia
condivideranno	gioia
condividesse	gioia
condividerete	gioia
condividesti	gioia
condividevano	gioia
condividevi	gioia
condividerai	gioia
condividessi	gioia
condividerò	gioia
condividerebbero	gioia
condivideremo	gioia
condivise	gioia
condivideremmo	gioia
condividemmo	gioia
condividano	gioia
condividente	gioia
condividerebbe	gioia
condivido	gioia
condividevo	gioia
condividiate	gioia
condividevate	gioia
condivida	gioia
condivide	gioia
condividessero	gioia
condivideste	gioia
condividete	gioia
condividere	gioia
condividenti	gioia
condivisi	gioia
condividerà	gioia
condividono	gioia
condividerei	gioia
condividessimo	gioia
condivideva	gioia
condivideresti	gioia
condividendo	gioia
condividereste	gioia
condividevamo	gioia
condividiamo	gioia
condivisero	gioia
condividi	gioia
rapsodie	gioia
rapsodia	gioia
trionfi	gioia
trionfo	gioia
sorrisi	gioia
sorriso	gioia
vivacissima	gioia
vivaci	gioia
vivace	gioia
vivacissimo	gioia
vivacissime	gioia
vivacissimi	gioia
festosità	gioia
esilaranti	gioia
esilarantissimi	gioia
esilarantissima	gioia
esilarantissimo	gioia
esilarante	gioia
esilarantissime	gioia
vincevamo	gioia
vincerei	gioia
vinsero	gioia
vincer	gioia
vinca	gioia
vinse	gioia
vinto	gioia
vincemmo	gioia
vincerò	gioia
vincesti	gioia
vincono	gioia
vincesse	gioia
vinte	gioia
vincerà	gioia
vincete	gioia
vinceranno	gioia
vincessimo	gioia
vinti	gioia
vincevo	gioia
vinciamo	gioia
vinciate	gioia
vincerebbero	gioia
vinceva	gioia
vincessero	gioia
vinceremmo	gioia
vinsi	gioia
vincerete	gioia
vincessi	gioia
vincente	gioia
vincenti	gioia
vinco	gioia
vincevano	gioia
vinceremo	gioia
vincereste	gioia
vinta	gioia
vincerai	gioia
vincendo	gioia
vincano	gioia
vincere	gioia
vincerebbe	gioia
vinceresti	gioia
vinceste	gioia
vincevate	gioia
vinci	gioia
vince	gioia
vincevi	gioia
esaltati	gioia
esaltino	gioia
esaltando	gioia
esaltassero	gioia
esalterai	gioia
esaltiate	gioia
esaltaste	gioia
esaltasti	gioia
esaltavamo	gioia
esalteranno	gioia
esaltavi	gioia
esaltai	gioia
esaltano	gioia
esalteremmo	gioia
esaltante	gioia
esaltar	gioia
esalti	gioia
esaltasse	gioia
esaltato	gioia
esalterebbero	gioia
esaltanti	gioia
esaltavano	gioia
esalto	gioia
esaltava	gioia
esalterei	gioia
esalterà	gioia
esaltammo	gioia
esaltassi	gioia
esaltavo	gioia
esalteresti	gioia
esaltiamo	gioia
esaltare	gioia
esalterete	gioia
esalterò	gioia
esaltate	gioia
esaltassimo	gioia
esaltavate	gioia
esalta	gioia
esaltata	gioia
esaltarono	gioia
esaltereste	gioia
esaltò	gioia
esalteremo	gioia
esalterebbe	gioia
esaltate	gioia
esaltata	gioia
esaltati	gioia
esaltato	gioia
pienezze	gioia
pienezza	gioia
ritroverete	gioia
ritroviamo	gioia
ritrovanti	gioia
ritrovati	gioia
ritroveremmo	gioia
ritrovo	gioia
ritrovammo	gioia
ritroverà	gioia
ritrovavo	gioia
ritrovavamo	gioia
ritrovar	gioia
ritrovavate	gioia
ritroverei	gioia
ritrovavi	gioia
ritroveresti	gioia
ritrova	gioia
ritrovate	gioia
ritrovavano	gioia
ritrovata	gioia
ritroveremo	gioia
ritrovasse	gioia
ritrovassimo	gioia
ritrovò	gioia
ritrovaste	gioia
ritrovai	gioia
ritroverebbero	gioia
ritrovato	gioia
ritrovante	gioia
ritrovasti	gioia
ritrovano	gioia
ritrovava	gioia
ritrovi	gioia
ritrovarono	gioia
ritrovereste	gioia
ritrovare	gioia
ritroviate	gioia
ritrovino	gioia
ritrovassi	gioia
ritroverai	gioia
ritroveranno	gioia
ritroverò	gioia
ritroverebbe	gioia
ritrovassero	gioia
ritrovando	gioia
spensieratosette	gioia
spensieratosetto	gioia
spensieratine	gioia
spensieratini	gioia
spensierataccie	gioia
spensieratina	gioia
spensierati	gioia
spensieratissimi	gioia
spensierataccii	gioia
spensieratino	gioia
spensierate	gioia
spensierataccia	gioia
spensieratissima	gioia
spensieratosetta	gioia
spensieratissime	gioia
spensierata	gioia
spensierataccio	gioia
spensieratissimo	gioia
spensieratosetti	gioia
spensierato	gioia
partecipando	gioia
parteciparono	gioia
partecipi	gioia
parteciperò	gioia
partecipante	gioia
parteciperemmo	gioia
partecipavate	gioia
partecipano	gioia
partecipavano	gioia
partecipiamo	gioia
partecipassi	gioia
partecipavi	gioia
partecipanti	gioia
partecipassero	gioia
parteciperebbero	gioia
parteciperesti	gioia
partecipassimo	gioia
partecipasti	gioia
partecipino	gioia
partecipate	gioia
partecipavo	gioia
partecipereste	gioia
parteciperà	gioia
parteciperai	gioia
partecipò	gioia
partecipai	gioia
partecipasse	gioia
partecipati	gioia
parteciperei	gioia
partecipammo	gioia
partecipaste	gioia
partecipata	gioia
partecipava	gioia
partecipiate	gioia
parteciperemo	gioia
partecipo	gioia
partecipar	gioia
partecipare	gioia
partecipavamo	gioia
parteciperanno	gioia
parteciperete	gioia
partecipato	gioia
partecipa	gioia
parteciperebbe	gioia
abbraccerò	gioia
abbracciando	gioia
abbracciassero	gioia
abbracciar	gioia
abbracciò	gioia
abbracciate	gioia
abbracciato	gioia
abbraccerei	gioia
abbracciare	gioia
abbraccio	gioia
abbracciasse	gioia
abbracciavo	gioia
abbracci	gioia
abbracciarono	gioia
abbracciavi	gioia
abbraccerebbero	gioia
abbracceremmo	gioia
abbraccerai	gioia
abbracciassi	gioia
abbracciata	gioia
abbraccereste	gioia
abbraccerete	gioia
abbracciavate	gioia
abbracciano	gioia
abbracciai	gioia
abbraccianti	gioia
abbracciasti	gioia
abbracciavano	gioia
abbraccerà	gioia
abbraccino	gioia
abbraccia	gioia
abbracciati	gioia
abbracciante	gioia
abbracceranno	gioia
abbracceresti	gioia
abbracciamo	gioia
abbracciassimo	gioia
abbracciavamo	gioia
abbracciammo	gioia
abbracciava	gioia
abbracceremo	gioia
abbraccerebbe	gioia
abbracciaste	gioia
entusiasmaste	gioia
entusiasmavi	gioia
entusiasma	gioia
entusiasmerete	gioia
entusiasmammo	gioia
entusiasmasse	gioia
entusiasmeresti	gioia
entusiasmate	gioia
entusiasmereste	gioia
entusiasmavano	gioia
entusiasmavo	gioia
entusiasmeremo	gioia
entusiasmato	gioia
entusiasmerà	gioia
entusiasmassero	gioia
entusiasmerò	gioia
entusiasmiamo	gioia
entusiasmerai	gioia
entusiasmava	gioia
entusiasmarono	gioia
entusiasmiate	gioia
entusiasmassi	gioia
entusiasmare	gioia
entusiasmeremmo	gioia
entusiasmeranno	gioia
entusiasmai	gioia
entusiasmi	gioia
entusiasmasti	gioia
entusiasmano	gioia
entusiasmata	gioia
entusiasmavamo	gioia
entusiasmante	gioia
entusiasmanti	gioia
entusiasmati	gioia
entusiasmino	gioia
entusiasmò	gioia
entusiasmerebbe	gioia
entusiasmerei	gioia
entusiasmo	gioia
entusiasmar	gioia
entusiasmando	gioia
entusiasmassimo	gioia
entusiasmavate	gioia
entusiasmerebbero	gioia
esilarate	gioia
esilarato	gioia
esilarata	gioia
esilarati	gioia
mari	gioia
mare	gioia
sole	gioia
esultata	gioia
esulta	gioia
esulterebbero	gioia
esultati	gioia
esultai	gioia
esultante	gioia
esulteresti	gioia
esultate	gioia
esultava	gioia
esultavi	gioia
esulti	gioia
esultiate	gioia
esultassimo	gioia
esultavamo	gioia
esultasti	gioia
esultato	gioia
esultereste	gioia
esulto	gioia
esultasse	gioia
esultare	gioia
esulterebbe	gioia
esultanti	gioia
esultiamo	gioia
esultar	gioia
esultaste	gioia
esultavate	gioia
esultassero	gioia
esulterai	gioia
esultammo	gioia
esultando	gioia
esultavano	gioia
esulteranno	gioia
esulteremo	gioia
esulterete	gioia
esulterei	gioia
esultassi	gioia
esultano	gioia
esulteremmo	gioia
esulterò	gioia
esultò	gioia
esultarono	gioia
esultavo	gioia
esulterà	gioia
esultino	gioia
eccitazione	gioia
eccitazioni	gioia
piacere	gioia
piaceri	gioia
deliziati	gioia
delizieresti	gioia
deliziando	gioia
delizieremmo	gioia
delizierete	gioia
delizio	gioia
deliziai	gioia
deliziiamo	gioia
deliziassero	gioia
deliziereste	gioia
deliziar	gioia
deliziasti	gioia
deliziavi	gioia
deliziiate	gioia
deliziava	gioia
delizierai	gioia
deliziano	gioia
deliziate	gioia
deliziasse	gioia
deliziammo	gioia
delizierà	gioia
deliziarono	gioia
deliziante	gioia
delizieranno	gioia
deliziare	gioia
deliziavate	gioia
deliziò	gioia
delizia	gioia
deliziino	gioia
delizieremo	gioia
delizianti	gioia
deliziaste	gioia
delizierei	gioia
deliziato	gioia
delizii	gioia
delizierebbero	gioia
deliziata	gioia
deliziavo	gioia
delizierebbe	gioia
deliziavano	gioia
delizierò	gioia
deliziassimo	gioia
deliziassi	gioia
deliziavamo	gioia
giubilereste	gioia
giubilo	gioia
giubilando	gioia
giubilavano	gioia
giubilerebbe	gioia
giubilavi	gioia
giubiliate	gioia
giubilai	gioia
giubilavo	gioia
giubilaste	gioia
giubila	gioia
giubilerò	gioia
giubilammo	gioia
giubilavate	gioia
giubilerà	gioia
giubilato	gioia
giubileremmo	gioia
giubilano	gioia
giubilata	gioia
giubilati	gioia
giubilare	gioia
giubilassi	gioia
giubileresti	gioia
giubilassimo	gioia
giubili	gioia
giubilava	gioia
giubilassero	gioia
giubilerei	gioia
giubilò	gioia
giubilanti	gioia
giubilerai	gioia
giubilavamo	gioia
giubileranno	gioia
giubileremo	gioia
giubilasse	gioia
giubilasti	gioia
giubilante	gioia
giubilerete	gioia
giubilino	gioia
giubilate	gioia
giubilar	gioia
giubilerebbero	gioia
giubilarono	gioia
giubiliamo	gioia
giocondini	gioia
giocondissimo	gioia
giocondaccii	gioia
giocondaccie	gioia
giocondosetti	gioia
gioconde	gioia
giocondissimi	gioia
giocondine	gioia
giocondosetta	gioia
giocondissime	gioia
giocondi	gioia
giocondaccio	gioia
giocondosetto	gioia
giocondino	gioia
giocondaccia	gioia
giocondosette	gioia
giocondina	gioia
gioconda	gioia
giocondo	gioia
giocondissima	gioia
ingiustosetto	rabbia
ingiustosetta	rabbia
ingiusti	rabbia
ingiustaccie	rabbia
ingiuste	rabbia
ingiustissimi	rabbia
ingiustaccio	rabbia
ingiustosetti	rabbia
ingiustaccia	rabbia
ingiustina	rabbia
ingiusto	rabbia
ingiustissime	rabbia
ingiustissimo	rabbia
ingiustissima	rabbia
ingiustini	rabbia
ingiustaccii	rabbia
ingiustino	rabbia
ingiustosette	rabbia
ingiusta	rabbia
ingiustine	rabbia
esplosiva	rabbia
esplosivi	rabbia
esplosivo	rabbia
esplosive	rabbia
irascibilissimo	rabbia
irascibilissima	rabbia
irascibilissime	rabbia
irascibili	rabbia
irascibilissimi	rabbia
irascibile	rabbia
pugno	rabbia
pugni	rabbia
vessazione	rabbia
vessazioni	rabbia
infuriato	rabbia
infuriata	rabbia
infuriate	rabbia
infuriati	rabbia
scontroso	rabbia
scontrose	rabbia
scontrosi	rabbia
scontrosissimi	rabbia
scontrosa	rabbia
scontrosaccio	rabbia
scontrosissima	rabbia
scontrosissime	rabbia
scontrosette	rabbia
scontrosaccii	rabbia
scontrosina	rabbia
scontrosaccia	rabbia
scontrosissimo	rabbia
scontrosetta	rabbia
scontrosino	rabbia
scontrosaccie	rabbia
scontrosini	rabbia
scontrosetto	rabbia
scontrosine	rabbia
scontrosetti	rabbia
invidiosine	rabbia
invidiosette	rabbia
invidiosissimo	rabbia
invidiosetta	rabbia
invidiosetto	rabbia
invidiosi	rabbia
invidiosissime	rabbia
invidiosaccio	rabbia
invidiosissimi	rabbia
invidiosissima	rabbia
invidiosaccia	rabbia
invidiosaccie	rabbia
invidiose	rabbia
invidiosetti	rabbia
invidiosa	rabbia
invidiosaccii	rabbia
invidioso	rabbia
invidiosino	rabbia
invidiosini	rabbia
invidiosina	rabbia
pazzi	rabbia
pazzo	rabbia
pazze	rabbia
pazza	rabbia
detestavo	rabbia
detestano	rabbia
detesti	rabbia
detestare	rabbia
detestammo	rabbia
detesta	rabbia
detestavano	rabbia
detesterete	rabbia
detestarono	rabbia
detesterei	rabbia
detestasti	rabbia
detesterebbero	rabbia
detestate	rabbia
detestava	rabbia
detestavamo	rabbia
detestavi	rabbia
detestò	rabbia
detestanti	rabbia
detesteremo	rabbia
detesteranno	rabbia
detesteresti	rabbia
detestiamo	rabbia
detestiate	rabbia
detestereste	rabbia
detestando	rabbia
detestasse	rabbia
detesteremmo	rabbia
detestino	rabbia
detestassimo	rabbia
detestati	rabbia
detestassi	rabbia
detesterai	rabbia
detestar	rabbia
detestai	rabbia
detesterà	rabbia
detestato	rabbia
detestavate	rabbia
detesterò	rabbia
detestante	rabbia
detestata	rabbia
detestassero	rabbia
detesto	rabbia
detesterebbe	rabbia
detestaste	rabbia
impotente	rabbia
impotenti	rabbia
isteriche	rabbia
isterica	rabbia
isterico	rabbia
isterici	rabbia
violentaccia	rabbia
violentine	rabbia
violenti	rabbia
violentino	rabbia
violentosette	rabbia
violentaccio	rabbia
violente	rabbia
violentini	rabbia
violentosetti	rabbia
violentissimo	rabbia
violentissimi	rabbia
violenta	rabbia
violentissime	rabbia
violentissima	rabbia
violento	rabbia
violentaccii	rabbia
violentosetto	rabbia
violentina	rabbia
violentosetta	rabbia
violentaccie	rabbia
gridate	rabbia
gridavi	rabbia
grideremmo	rabbia
gridando	rabbia
gridar	rabbia
grideresti	rabbia
griderai	rabbia
gridano	rabbia
griderete	rabbia
gridi	rabbia
griderei	rabbia
gridavate	rabbia
gridare	rabbia
gridante	rabbia
grideremo	rabbia
gridasse	rabbia
gridavamo	rabbia
gridava	rabbia
griderebbero	rabbia
gridavo	rabbia
griderò	rabbia
gridassero	rabbia
gridiamo	rabbia
gridarono	rabbia
gridassi	rabbia
gridammo	rabbia
gridai	rabbia
grideranno	rabbia
grida	rabbia
griderà	rabbia
gridereste	rabbia
gridavano	rabbia
gridaste	rabbia
gridasti	rabbia
grido	rabbia
gridanti	rabbia
gridò	rabbia
gridino	rabbia
griderebbe	rabbia
gridato	rabbia
gridata	rabbia
gridiate	rabbia
gridati	rabbia
gridassimo	rabbia
rabbie	rabbia
rabbia	rabbia
infuriano	rabbia
infurierò	rabbia
infuriassimo	rabbia
infurierebbe	rabbia
infuriava	rabbia
infuriassi	rabbia
infurierà	rabbia
infuriasti	rabbia
infuriata	rabbia
infurierai	rabbia
infurierete	rabbia
infuriereste	rabbia
infuriò	rabbia
infuria	rabbia
infuriasse	rabbia
infurierei	rabbia
infuriiamo	rabbia
infuriante	rabbia
infuriiate	rabbia
infurii	rabbia
infuriar	rabbia
infuriassero	rabbia
infuriammo	rabbia
infuriarono	rabbia
infuriando	rabbia
infurieremmo	rabbia
infuriavi	rabbia
infuriati	rabbia
infuriino	rabbia
infuriavo	rabbia
infuriavamo	rabbia
infurieranno	rabbia
infurierebbero	rabbia
infurio	rabbia
infuriai	rabbia
infuriate	rabbia
infuriavano	rabbia
infuriare	rabbia
infuriavate	rabbia
infurieresti	rabbia
infurianti	rabbia
infuriaste	rabbia
infurieremo	rabbia
infuriato	rabbia
impetuosine	rabbia
impetuosissimo	rabbia
impetuosaccio	rabbia
impetuose	rabbia
impetuosetta	rabbia
impetuosa	rabbia
impetuosino	rabbia
impetuosissime	rabbia
impetuoso	rabbia
impetuosissima	rabbia
impetuosetti	rabbia
impetuosi	rabbia
impetuosetto	rabbia
impetuosina	rabbia
impetuosissimi	rabbia
impetuosaccia	rabbia
impetuosaccie	rabbia
impetuosaccii	rabbia
impetuosette	rabbia
impetuosini	rabbia
nervosismi	rabbia
nervosismo	rabbia
aggrediti	rabbia
aggredissero	rabbia
aggredirai	rabbia
aggredissimo	rabbia
aggredisse	rabbia
aggredire	rabbia
aggredirebbe	rabbia
aggredisco	rabbia
aggredisca	rabbia
aggrediate	rabbia
aggrediva	rabbia
aggredirete	rabbia
aggredii	rabbia
aggredivate	rabbia
aggredita	rabbia
aggredirei	rabbia
aggredite	rabbia
aggredì	rabbia
aggrediresti	rabbia
aggrediremo	rabbia
aggredirono	rabbia
aggredisce	rabbia
aggredendo	rabbia
aggrediamo	rabbia
aggredirebbero	rabbia
aggredirò	rabbia
aggredivano	rabbia
aggrediste	rabbia
aggredivo	rabbia
aggredirà	rabbia
aggredissi	rabbia
aggredir	rabbia
aggredito	rabbia
aggrediscono	rabbia
aggrediscano	rabbia
aggredivamo	rabbia
aggredireste	rabbia
aggredimmo	rabbia
aggredente	rabbia
aggrediranno	rabbia
aggredisti	rabbia
aggredisci	rabbia
aggrediremmo	rabbia
aggredivi	rabbia
aggredenti	rabbia
imbestialito	rabbia
imbestialite	rabbia
imbestialita	rabbia
imbestialiti	rabbia
picchia	rabbia
picchiar	rabbia
picchierebbe	rabbia
picchiata	rabbia
picchiai	rabbia
picchieremmo	rabbia
picchiassero	rabbia
picchiavamo	rabbia
picchierò	rabbia
picchiasti	rabbia
picchiare	rabbia
picchierei	rabbia
picchiereste	rabbia
picchieremo	rabbia
picchiasse	rabbia
picchianti	rabbia
picchiati	rabbia
picchiassimo	rabbia
picchierai	rabbia
picchieranno	rabbia
picchiavano	rabbia
picchiava	rabbia
picchiano	rabbia
picchieresti	rabbia
picchiavate	rabbia
picchiò	rabbia
picchierebbero	rabbia
picchiassi	rabbia
picchiato	rabbia
picchiammo	rabbia
picchio	rabbia
picchiate	rabbia
picchierete	rabbia
picchierà	rabbia
picchiante	rabbia
picchiavo	rabbia
picchiarono	rabbia
picchiando	rabbia
picchiavi	rabbia
picchiaste	rabbia
irritabilità	rabbia
adombri	rabbia
adombriamo	rabbia
adombrati	rabbia
adombrerò	rabbia
adombravate	rabbia
adombriate	rabbia
adombrava	rabbia
adombrate	rabbia
adombrato	rabbia
adombreranno	rabbia
adombrasti	rabbia
adombrata	rabbia
adombro	rabbia
adombravano	rabbia
adombrare	rabbia
adombrerebbe	rabbia
adombravamo	rabbia
adombrò	rabbia
adombrerebbero	rabbia
adombreremo	rabbia
adombrassimo	rabbia
adombrai	rabbia
adombravi	rabbia
adombrerai	rabbia
adombreremmo	rabbia
adombranti	rabbia
adombraste	rabbia
adombrante	rabbia
adombra	rabbia
adombrarono	rabbia
adombrereste	rabbia
adombrando	rabbia
adombrasse	rabbia
adombrerà	rabbia
adombreresti	rabbia
adombrano	rabbia
adombrassi	rabbia
adombrar	rabbia
adombrassero	rabbia
adombrerete	rabbia
adombrino	rabbia
adombrammo	rabbia
adombrerei	rabbia
adombravo	rabbia
reagisca	rabbia
reagiremmo	rabbia
reagiste	rabbia
reagissero	rabbia
reagirono	rabbia
reagimmo	rabbia
reagireste	rabbia
reagisci	rabbia
reagirai	rabbia
reagivamo	rabbia
reagissi	rabbia
reagirebbe	rabbia
reagirò	rabbia
reagirete	rabbia
reagiremo	rabbia
reagiamo	rabbia
reagisce	rabbia
reagirei	rabbia
reagirà	rabbia
reagirebbero	rabbia
reagenti	rabbia
reagissimo	rabbia
reagente	rabbia
reagiscono	rabbia
reagiva	rabbia
reagendo	rabbia
reagisco	rabbia
reagiranno	rabbia
reagì	rabbia
reagiresti	rabbia
reagire	rabbia
reagito	rabbia
reagivate	rabbia
reagiate	rabbia
reagita	rabbia
reagiti	rabbia
reagite	rabbia
reagir	rabbia
reagivi	rabbia
reagisse	rabbia
reagivano	rabbia
reagivo	rabbia
reagii	rabbia
reagiscano	rabbia
reagisti	rabbia
violenza	rabbia
violenze	rabbia
capricci	rabbia
capriccio	rabbia
malumore	rabbia
malumori	rabbia
imbestialita	rabbia
imbestialite	rabbia
imbestialisse	rabbia
imbestialiscono	rabbia
imbestialissimo	rabbia
imbestialirebbero	rabbia
imbestialivamo	rabbia
imbestialiresti	rabbia
imbestialiti	rabbia
imbestialirò	rabbia
imbestialito	rabbia
imbestialisti	rabbia
imbestialirà	rabbia
imbestialissero	rabbia
imbestialisci	rabbia
imbestialente	rabbia
imbestialii	rabbia
imbestialirono	rabbia
imbestialisca	rabbia
imbestialisce	rabbia
imbestialiva	rabbia
imbestialir	rabbia
imbestialirei	rabbia
imbestialireste	rabbia
imbestialirai	rabbia
imbestialire	rabbia
imbestialiste	rabbia
imbestialimmo	rabbia
imbestialiremmo	rabbia
imbestialirete	rabbia
imbestialiscano	rabbia
imbestialì	rabbia
imbestialivi	rabbia
imbestialivo	rabbia
imbestialiamo	rabbia
imbestialiranno	rabbia
imbestialendo	rabbia
imbestialissi	rabbia
imbestialiate	rabbia
imbestialivate	rabbia
imbestialiremo	rabbia
imbestialenti	rabbia
imbestialisco	rabbia
imbestialivano	rabbia
imbestialirebbe	rabbia
manie	rabbia
mania	rabbia
arrabbiatura	rabbia
arrabbiature	rabbia
oltraggio	rabbia
oltraggi	rabbia
ira	rabbia
ire	rabbia
petulanze	rabbia
petulanza	rabbia
istintivosette	rabbia
istintivaccie	rabbia
istintivissime	rabbia
istintivino	rabbia
istintivissimi	rabbia
istintivaccio	rabbia
istintiva	rabbia
istintivi	rabbia
istintivosetta	rabbia
istintivaccii	rabbia
istintivissima	rabbia
istintivosetto	rabbia
istintivissimo	rabbia
istintivaccia	rabbia
istintive	rabbia
istintivina	rabbia
istintivini	rabbia
istintivine	rabbia
istintivosetti	rabbia
istintivo	rabbia
irritabilissimo	rabbia
irritabili	rabbia
irritabilissime	rabbia
irritabilissimi	rabbia
irritabile	rabbia
irritabilissima	rabbia
odi	rabbia
odio	rabbia
furenti	rabbia
furente	rabbia
idrofobo	rabbia
idrofobe	rabbia
idrofoba	rabbia
idrofobi	rabbia
rompessi	rabbia
romperemmo	rabbia
rompessimo	rabbia
rompevo	rabbia
romperebbe	rabbia
rompa	rabbia
rompo	rabbia
rotti	rabbia
romperanno	rabbia
rompenti	rabbia
rompano	rabbia
ruppi	rabbia
rompevamo	rabbia
rompe	rabbia
rompeva	rabbia
rompi	rabbia
rompeste	rabbia
rompere	rabbia
rompono	rabbia
rotto	rabbia
romper	rabbia
rompete	rabbia
romperò	rabbia
rotte	rabbia
rompente	rabbia
romperai	rabbia
rotta	rabbia
rompereste	rabbia
romperebbero	rabbia
romperesti	rabbia
romperete	rabbia
romperà	rabbia
rompendo	rabbia
ruppero	rabbia
ruppe	rabbia
rompiamo	rabbia
rompevano	rabbia
rompevi	rabbia
romperei	rabbia
rompiate	rabbia
rompesti	rabbia
rompemmo	rabbia
rompesse	rabbia
rompevate	rabbia
romperemo	rabbia
rompessero	rabbia
furia	rabbia
furie	rabbia
indignata	rabbia
indignati	rabbia
indignato	rabbia
indignate	rabbia
vessavano	rabbia
vesserei	rabbia
vesso	rabbia
vessante	rabbia
vessato	rabbia
vessassimo	rabbia
vessavate	rabbia
vessasti	rabbia
vesserete	rabbia
vessate	rabbia
vessavo	rabbia
vesserai	rabbia
vessiate	rabbia
vessavamo	rabbia
vesserò	rabbia
vessi	rabbia
vessò	rabbia
vessasse	rabbia
vessereste	rabbia
vessammo	rabbia
vessava	rabbia
vessino	rabbia
vessar	rabbia
vessano	rabbia
vesseresti	rabbia
vessanti	rabbia
vessare	rabbia
vesseremmo	rabbia
vessavi	rabbia
vessassero	rabbia
vessati	rabbia
vesserà	rabbia
vessassi	rabbia
vessata	rabbia
vessaste	rabbia
vesseremo	rabbia
vessarono	rabbia
vesseranno	rabbia
vessai	rabbia
vessando	rabbia
vessa	rabbia
vesserebbe	rabbia
vesserebbero	rabbia
vessiamo	rabbia
irritato	rabbia
irritati	rabbia
irritate	rabbia
irritata	rabbia
prepotente	rabbia
prepotenti	rabbia
prepotentissimo	rabbia
prepotentissime	rabbia
prepotentissimi	rabbia
prepotentissima	rabbia
accanimento	rabbia
accanimenti	rabbia
schiaffi	rabbia
schiaffo	rabbia
rosso	rabbia
rosse	rabbia
rossa	rabbia
rossi	rabbia
folle	rabbia
folli	rabbia
vessate	rabbia
vessata	rabbia
vessati	rabbia
vessato	rabbia
controlli	rabbia
controllo	rabbia
sfogo	rabbia
sfoghi	rabbia
grido	rabbia
grida	rabbia
iraconde	rabbia
iracondaccie	rabbia
iracondosetta	rabbia
iracondissimo	rabbia
iracondissime	rabbia
iracondino	rabbia
iracondaccio	rabbia
iracondaccia	rabbia
iracondi	rabbia
iracondini	rabbia
iracondissimi	rabbia
iracondo	rabbia
iraconda	rabbia
iracondina	rabbia
iracondissima	rabbia
iracondosetti	rabbia
iracondosette	rabbia
iracondaccii	rabbia
iracondine	rabbia
iracondosetto	rabbia
insultassimo	rabbia
insulteresti	rabbia
insulterete	rabbia
insulto	rabbia
insultava	rabbia
insulterò	rabbia
insultar	rabbia
insultasse	rabbia
insulterebbero	rabbia
insultanti	rabbia
insultiamo	rabbia
insulti	rabbia
insultò	rabbia
insultante	rabbia
insultavo	rabbia
insulteremmo	rabbia
insultaste	rabbia
insultassero	rabbia
insultarono	rabbia
insultino	rabbia
insultasti	rabbia
insultavi	rabbia
insultavamo	rabbia
insultavano	rabbia
insultiate	rabbia
insulterei	rabbia
insultate	rabbia
insultati	rabbia
insulta	rabbia
insulterebbe	rabbia
insulteremo	rabbia
insulteranno	rabbia
insulterai	rabbia
insultata	rabbia
insulterà	rabbia
insultare	rabbia
insultassi	rabbia
insultato	rabbia
insultando	rabbia
insultano	rabbia
insultai	rabbia
insultavate	rabbia
insultammo	rabbia
insultereste	rabbia
arrabbiato	rabbia
arrabbiate	rabbia
arrabbiati	rabbia
arrabbiata	rabbia
furiosino	rabbia
furiosaccie	rabbia
furiosi	rabbia
furiosaccia	rabbia
furiosetta	rabbia
furiosetto	rabbia
furiosetti	rabbia
furiosissima	rabbia
furiosaccii	rabbia
furiosette	rabbia
furiosissimo	rabbia
furiosa	rabbia
furiosine	rabbia
furioso	rabbia
furiosini	rabbia
furiosissimi	rabbia
furiose	rabbia
furiosissime	rabbia
furiosaccio	rabbia
furiosina	rabbia
nervosetta	rabbia
nervosaccii	rabbia
nervosi	rabbia
nervosini	rabbia
nervoso	rabbia
nervosetti	rabbia
nervosaccia	rabbia
nervosino	rabbia
nervosissima	rabbia
nervosaccie	rabbia
nervose	rabbia
nervosissime	rabbia
nervosine	rabbia
nervosaccio	rabbia
nervosissimi	rabbia
nervosetto	rabbia
nervosissimo	rabbia
nervosina	rabbia
nervosette	rabbia
nervosa	rabbia
incazzate	rabbia
incazzata	rabbia
incazzati	rabbia
incazzato	rabbia
irascibilità	rabbia
reazioni	rabbia
reazione	rabbia
distruggesti	rabbia
distruggenti	rabbia
distruggevano	rabbia
distrutta	rabbia
distruggerei	rabbia
distruggeranno	rabbia
distruggeremmo	rabbia
distruggereste	rabbia
distrutti	rabbia
distrussero	rabbia
distrusse	rabbia
distruggeremo	rabbia
distruggeresti	rabbia
distruggi	rabbia
distrugge	rabbia
distruggevate	rabbia
distruggiamo	rabbia
distruggiate	rabbia
distruggemmo	rabbia
distruggerebbero	rabbia
distruggerà	rabbia
distrussi	rabbia
distruggendo	rabbia
distrugga	rabbia
distruggesse	rabbia
distrutte	rabbia
distruggevo	rabbia
distruggo	rabbia
distrugger	rabbia
distruggono	rabbia
distruggano	rabbia
distrutto	rabbia
distruggevamo	rabbia
distruggerai	rabbia
distruggerebbe	rabbia
distruggere	rabbia
distruggevi	rabbia
distruggeste	rabbia
distruggente	rabbia
distruggessi	rabbia
distruggerete	rabbia
distruggerò	rabbia
distruggessero	rabbia
distruggeva	rabbia
distruggete	rabbia
distruggessimo	rabbia
indignazione	rabbia
indignaziona	rabbia
incomprensioni	rabbia
incomprensione	rabbia
collere	rabbia
collera	rabbia
incontrollabile	rabbia
incontrollabili	rabbia
rosso	rabbia
rosse	rabbia
rossa	rabbia
rossi	rabbia
silenzi	rabbia
silenzio	rabbia
inviperiti	rabbia
inviperita	rabbia
inviperite	rabbia
inviperito	rabbia
adombrate	rabbia
adombrata	rabbia
adombrato	rabbia
adombrati	rabbia
strabiliato	sorpresa
strabiliate	sorpresa
strabiliati	sorpresa
strabiliata	sorpresa
meraviglia	sorpresa
meraviglie	sorpresa
aperta	sorpresa
apriamo	sorpresa
apriste	sorpresa
aprenti	sorpresa
aprisse	sorpresa
aprono	sorpresa
apri	sorpresa
apro	sorpresa
apra	sorpresa
aperte	sorpresa
aprirono	sorpresa
aprissi	sorpresa
apre	sorpresa
apriremmo	sorpresa
aprire	sorpresa
aprirebbe	sorpresa
aprivamo	sorpresa
aprendo	sorpresa
aprimmo	sorpresa
aprite	sorpresa
aprivano	sorpresa
aprirete	sorpresa
aperti	sorpresa
apriranno	sorpresa
aprì	sorpresa
aprii	sorpresa
apriresti	sorpresa
aprirai	sorpresa
aprirebbero	sorpresa
aprente	sorpresa
apristi	sorpresa
apriva	sorpresa
aprivo	sorpresa
aprissero	sorpresa
aprivate	sorpresa
aprano	sorpresa
aprirò	sorpresa
aprissimo	sorpresa
aprirà	sorpresa
aperto	sorpresa
apriremo	sorpresa
apriate	sorpresa
aprirei	sorpresa
aprireste	sorpresa
aprivi	sorpresa
aprir	sorpresa
sbigottita	sorpresa
sbigottiti	sorpresa
sbigottito	sorpresa
sbigottite	sorpresa
attonitissima	sorpresa
attonitaccii	sorpresa
attonitina	sorpresa
attonitaccie	sorpresa
attonitaccio	sorpresa
attonitosetto	sorpresa
attonite	sorpresa
attonitissimo	sorpresa
attonitosette	sorpresa
attonitine	sorpresa
attonitini	sorpresa
attonitaccia	sorpresa
attonitissime	sorpresa
attonitosetta	sorpresa
attonitissimi	sorpresa
attoniti	sorpresa
attonitino	sorpresa
attonitosetti	sorpresa
attonita	sorpresa
attonito	sorpresa
improvvisate	sorpresa
improvvisata	sorpresa
regali	sorpresa
regalo	sorpresa
piacevolissimi	sorpresa
piacevole	sorpresa
piacevolissima	sorpresa
piacevolissime	sorpresa
piacevolissimo	sorpresa
piacevoli	sorpresa
inaspettataccie	sorpresa
inaspettato	sorpresa
inaspettatosetti	sorpresa
inaspettatina	sorpresa
inaspettatino	sorpresa
inaspettatissime	sorpresa
inaspettataccii	sorpresa
inaspettata	sorpresa
inaspettataccio	sorpresa
inaspettatine	sorpresa
inaspettatissimo	sorpresa
inaspettati	sorpresa
inaspettatosette	sorpresa
inaspettatini	sorpresa
inaspettataccia	sorpresa
inaspettatosetta	sorpresa
inaspettatosetto	sorpresa
inaspettatissimi	sorpresa
inaspettate	sorpresa
inaspettatissima	sorpresa
sbalordito	sorpresa
sbalordite	sorpresa
sbalordita	sorpresa
sbalorditi	sorpresa
stupore	sorpresa
stupori	sorpresa
sbalordiva	sorpresa
sbalordendo	sorpresa
sbalordirà	sorpresa
sbalordirebbero	sorpresa
sbalordito	sorpresa
sbalordite	sorpresa
sbalordii	sorpresa
sbalordiremmo	sorpresa
sbalordiamo	sorpresa
sbalordirò	sorpresa
sbalordivi	sorpresa
sbalordenti	sorpresa
sbalordissi	sorpresa
sbalordivo	sorpresa
sbalordisca	sorpresa
sbalordiresti	sorpresa
sbalordì	sorpresa
sbalordente	sorpresa
sbalordiranno	sorpresa
sbalordivate	sorpresa
sbalordiscano	sorpresa
sbalordissero	sorpresa
sbalordivamo	sorpresa
sbalordiscono	sorpresa
sbalordisce	sorpresa
sbalordiate	sorpresa
sbalordirai	sorpresa
sbalordir	sorpresa
sbalordirei	sorpresa
sbalordisco	sorpresa
sbalordire	sorpresa
sbalordirete	sorpresa
sbalordivano	sorpresa
sbalordissimo	sorpresa
sbalordisti	sorpresa
sbalordiste	sorpresa
sbalordirebbe	sorpresa
sbalorditi	sorpresa
sbalordimmo	sorpresa
sbalordirono	sorpresa
sbalordiremo	sorpresa
sbalordireste	sorpresa
sbalordisci	sorpresa
sbalordita	sorpresa
sbalordisse	sorpresa
godevi	sorpresa
godevo	sorpresa
godesse	sorpresa
godute	sorpresa
goder	sorpresa
godeste	sorpresa
godrebbero	sorpresa
godrai	sorpresa
godessi	sorpresa
godremo	sorpresa
goduto	sorpresa
godranno	sorpresa
godente	sorpresa
goduta	sorpresa
godendo	sorpresa
godenti	sorpresa
godrò	sorpresa
godevano	sorpresa
godrebbe	sorpresa
godevate	sorpresa
godesti	sorpresa
godresti	sorpresa
godrei	sorpresa
godettero	sorpresa
godi	sorpresa
godremmo	sorpresa
goduti	sorpresa
godette	sorpresa
gode	sorpresa
godiamo	sorpresa
godevamo	sorpresa
godrete	sorpresa
godiate	sorpresa
godrà	sorpresa
godemmo	sorpresa
godreste	sorpresa
godere	sorpresa
godano	sorpresa
godete	sorpresa
godessimo	sorpresa
godo	sorpresa
godeva	sorpresa
godessero	sorpresa
godono	sorpresa
godetti	sorpresa
goda	sorpresa
scartano	sorpresa
scartassi	sorpresa
scartavate	sorpresa
scartando	sorpresa
scartata	sorpresa
scartai	sorpresa
scartereste	sorpresa
scarterei	sorpresa
scartassero	sorpresa
scartiamo	sorpresa
scartate	sorpresa
scarteremmo	sorpresa
scartavi	sorpresa
scartino	sorpresa
scartammo	sorpresa
scarterà	sorpresa
scartati	sorpresa
scartasse	sorpresa
scartare	sorpresa
scartavano	sorpresa
scartavo	sorpresa
scarto	sorpresa
scarterò	sorpresa
scartato	sorpresa
scartanti	sorpresa
scartiate	sorpresa
scartò	sorpresa
scartassimo	sorpresa
scarterai	sorpresa
scartante	sorpresa
scartaste	sorpresa
scarta	sorpresa
scarterete	sorpresa
scarteresti	sorpresa
scartarono	sorpresa
scarterebbe	sorpresa
scarti	sorpresa
scartavamo	sorpresa
scarteremo	sorpresa
scartasti	sorpresa
scartar	sorpresa
scartava	sorpresa
scarteranno	sorpresa
scarterebbero	sorpresa
compleanno	sorpresa
compleanni	sorpresa
sorpresa	sorpresa
sorprese	sorpresa
scioccati	sorpresa
scioccata	sorpresa
scioccate	sorpresa
scioccato	sorpresa
incredulini	sorpresa
incredulissime	sorpresa
incredulosetti	sorpresa
incredulosetto	sorpresa
incredulaccie	sorpresa
incredulina	sorpresa
incredulaccio	sorpresa
incredulo	sorpresa
increduline	sorpresa
incredulissimo	sorpresa
incredulissimi	sorpresa
incredulino	sorpresa
incredule	sorpresa
incredula	sorpresa
incredulosetta	sorpresa
incredulissima	sorpresa
increduli	sorpresa
incredulosette	sorpresa
incredulaccii	sorpresa
incredulaccia	sorpresa
stupiti	sorpresa
stupite	sorpresa
stupito	sorpresa
stupita	sorpresa
sorpreso	sorpresa
sorpresa	sorpresa
sorprese	sorpresa
sorpresi	sorpresa
strabiliando	sorpresa
strabilierete	sorpresa
strabiliaste	sorpresa
strabiliante	sorpresa
strabiliereste	sorpresa
strabiliassi	sorpresa
strabilio	sorpresa
strabilino	sorpresa
strabiliammo	sorpresa
strabiliano	sorpresa
strabiliasti	sorpresa
strabiliavo	sorpresa
strabiliar	sorpresa
strabilierò	sorpresa
strabiliassero	sorpresa
strabiliava	sorpresa
strabilianti	sorpresa
strabilia	sorpresa
strabiliò	sorpresa
strabiliavi	sorpresa
strabilierai	sorpresa
strabiliate	sorpresa
strabilieremmo	sorpresa
strabilieranno	sorpresa
strabilierà	sorpresa
strabiliata	sorpresa
strabiliavate	sorpresa
strabilierebbe	sorpresa
strabiliasse	sorpresa
strabilieresti	sorpresa
strabiliati	sorpresa
strabiliavamo	sorpresa
strabiliamo	sorpresa
strabiliassimo	sorpresa
strabiliare	sorpresa
strabilierei	sorpresa
strabilierebbero	sorpresa
strabili	sorpresa
strabiliarono	sorpresa
strabiliai	sorpresa
strabiliato	sorpresa
strabilieremo	sorpresa
strabiliavano	sorpresa
scioccare	sorpresa
scioccasti	sorpresa
scioccato	sorpresa
scioccherai	sorpresa
scioccheremmo	sorpresa
scioccheremo	sorpresa
scioccherà	sorpresa
scioccanti	sorpresa
sciocchi	sorpresa
sciocca	sorpresa
scioccammo	sorpresa
scioccando	sorpresa
scioccai	sorpresa
scioccarono	sorpresa
scioccò	sorpresa
scioccata	sorpresa
scioccavamo	sorpresa
scioccavo	sorpresa
scioccavate	sorpresa
scioccati	sorpresa
scioccheranno	sorpresa
scioccante	sorpresa
scioccar	sorpresa
scioccassimo	sorpresa
scioccherebbero	sorpresa
sciocchiamo	sorpresa
scioccassero	sorpresa
scioccasse	sorpresa
scioccano	sorpresa
scioccaste	sorpresa
sciocchiate	sorpresa
scioccherebbe	sorpresa
scioccassi	sorpresa
sciocchino	sorpresa
scioccava	sorpresa
sciocco	sorpresa
scioccheresti	sorpresa
scioccavi	sorpresa
scioccherei	sorpresa
sciocchereste	sorpresa
scioccate	sorpresa
scioccavano	sorpresa
scioccherò	sorpresa
scioccherete	sorpresa
gioia	sorpresa
gioie	sorpresa
sorprendenti	sorpresa
sorprendentissime	sorpresa
sorprendentissimo	sorpresa
sorprendentissimi	sorpresa
sorprendente	sorpresa
sorprendentissima	sorpresa
feste	sorpresa
festa	sorpresa
meraviglieremo	sorpresa
meraviglierei	sorpresa
meravigliassi	sorpresa
meravigliammo	sorpresa
meravigliamo	sorpresa
meravigliati	sorpresa
meravigliereste	sorpresa
meravigliasti	sorpresa
meraviglio	sorpresa
meraviglia	sorpresa
meravigliano	sorpresa
meraviglierò	sorpresa
meravigliando	sorpresa
meravigliate	sorpresa
meravigliavate	sorpresa
meraviglierebbero	sorpresa
meravigli	sorpresa
meravigliavano	sorpresa
meravigliassimo	sorpresa
meravigliar	sorpresa
meravigliavamo	sorpresa
meravigliavi	sorpresa
meravigliaste	sorpresa
meravigliata	sorpresa
meraviglierai	sorpresa
meraviglino	sorpresa
meravigliassero	sorpresa
meraviglianti	sorpresa
meraviglierà	sorpresa
meravigliava	sorpresa
meravigliarono	sorpresa
meravigliante	sorpresa
meravigliai	sorpresa
meravigliavo	sorpresa
meraviglierebbe	sorpresa
meraviglierete	sorpresa
meravigliò	sorpresa
meravigliare	sorpresa
meraviglieranno	sorpresa
meraviglieresti	sorpresa
meravigliasse	sorpresa
meravigliato	sorpresa
meraviglieremmo	sorpresa
meravigliato	sorpresa
meravigliata	sorpresa
meravigliate	sorpresa
meravigliati	sorpresa
curiosaccii	sorpresa
curiosette	sorpresa
curiosetti	sorpresa
curiosissimo	sorpresa
curiosissime	sorpresa
curiosini	sorpresa
curiose	sorpresa
curiosine	sorpresa
curiosetta	sorpresa
curiosaccia	sorpresa
curiosetto	sorpresa
curioso	sorpresa
curiosaccie	sorpresa
curiosaccio	sorpresa
curiosi	sorpresa
curiosino	sorpresa
curiosissima	sorpresa
curiosissimi	sorpresa
curiosa	sorpresa
curiosina	sorpresa
sconcertata	sorpresa
sconcertati	sorpresa
sconcertato	sorpresa
sconcertate	sorpresa
insolito	sorpresa
insolita	sorpresa
insoliti	sorpresa
insolite	sorpresa
improvviserete	sorpresa
improvvisanti	sorpresa
improvvisa	sorpresa
improvvisammo	sorpresa
improvviserei	sorpresa
improvvisino	sorpresa
improvviserebbero	sorpresa
improvvisaste	sorpresa
improvvisando	sorpresa
improvvisato	sorpresa
improvvisavo	sorpresa
improvvisasse	sorpresa
improvvisar	sorpresa
improvvisereste	sorpresa
improvviseranno	sorpresa
improvvisante	sorpresa
improvvisassero	sorpresa
improvvisavamo	sorpresa
improvvisavi	sorpresa
improvvisò	sorpresa
improvvisava	sorpresa
improvvisare	sorpresa
improvviserai	sorpresa
improvviseremmo	sorpresa
improvvisai	sorpresa
improvvisi	sorpresa
improvviserebbe	sorpresa
improvvisassi	sorpresa
improvviso	sorpresa
improvviseremo	sorpresa
improvvisata	sorpresa
improvvisate	sorpresa
improvvisavate	sorpresa
improvvisarono	sorpresa
improvviserà	sorpresa
improvvisassimo	sorpresa
improvvisiamo	sorpresa
improvvisati	sorpresa
improvvisavano	sorpresa
improvviserò	sorpresa
improvvisasti	sorpresa
improvvisiate	sorpresa
improvvisano	sorpresa
improvviseresti	sorpresa
novità	sorpresa
emozione	sorpresa
emozioni	sorpresa
trasalite	sorpresa
trasalita	sorpresa
trasaliti	sorpresa
trasalito	sorpresa
colpi	sorpresa
colpo	sorpresa
scatola	sorpresa
scatole	sorpresa
scoprirà	sorpresa
scopro	sorpresa
scopre	sorpresa
scoprirai	sorpresa
scopriamo	sorpresa
scopriste	sorpresa
scopriate	sorpresa
scoprisse	sorpresa
scoperti	sorpresa
scopriresti	sorpresa
scoprì	sorpresa
scoperte	sorpresa
scoprir	sorpresa
scoperta	sorpresa
scoprivate	sorpresa
scoprivo	sorpresa
scopriremo	sorpresa
scoprissimo	sorpresa
scoprivamo	sorpresa
scoprivano	sorpresa
scoprirò	sorpresa
scopra	sorpresa
scoprendo	sorpresa
scoprii	sorpresa
scoprimmo	sorpresa
scoprirete	sorpresa
scoperto	sorpresa
scoprenti	sorpresa
scoprirebbero	sorpresa
scoprivi	sorpresa
scopriranno	sorpresa
scoprirebbe	sorpresa
scoprire	sorpresa
scoprirono	sorpresa
scoprirei	sorpresa
scopristi	sorpresa
scoprite	sorpresa
scopriva	sorpresa
scoprissero	sorpresa
scoprono	sorpresa
scoprireste	sorpresa
scoprano	sorpresa
scoprissi	sorpresa
scoprente	sorpresa
scopri	sorpresa
scopriremmo	sorpresa
trasecolerebbe	sorpresa
trasecola	sorpresa
trasecolarono	sorpresa
trasecolerete	sorpresa
trasecolerò	sorpresa
trasecolava	sorpresa
trasecoli	sorpresa
trasecolavate	sorpresa
trasecolo	sorpresa
trasecolerei	sorpresa
trasecolavi	sorpresa
trasecolerà	sorpresa
trasecolassero	sorpresa
trasecolar	sorpresa
trasecolate	sorpresa
trasecolante	sorpresa
trasecolavo	sorpresa
trasecolando	sorpresa
trasecolerai	sorpresa
trasecolammo	sorpresa
trasecolereste	sorpresa
trasecolerebbero	sorpresa
trasecolare	sorpresa
trasecoliate	sorpresa
trasecolò	sorpresa
trasecoleremmo	sorpresa
trasecolaste	sorpresa
trasecolassimo	sorpresa
trasecolano	sorpresa
trasecolato	sorpresa
trasecolasse	sorpresa
trasecolai	sorpresa
trasecolati	sorpresa
trasecoleresti	sorpresa
trasecolavamo	sorpresa
trasecolino	sorpresa
trasecoleremo	sorpresa
trasecolanti	sorpresa
trasecoliamo	sorpresa
trasecoleranno	sorpresa
trasecolasti	sorpresa
trasecolassi	sorpresa
trasecolata	sorpresa
trasecolavano	sorpresa
festeggiati	sorpresa
festeggiavano	sorpresa
festeggiasse	sorpresa
festeggerebbe	sorpresa
festeggeresti	sorpresa
festeggi	sorpresa
festeggiò	sorpresa
festeggiavo	sorpresa
festeggiassero	sorpresa
festeggiano	sorpresa
festeggianti	sorpresa
festeggiavamo	sorpresa
festeggio	sorpresa
festeggerebbero	sorpresa
festeggiata	sorpresa
festeggino	sorpresa
festeggiamo	sorpresa
festeggiar	sorpresa
festeggiato	sorpresa
festeggerà	sorpresa
festeggiammo	sorpresa
festeggiasti	sorpresa
festeggeremo	sorpresa
festeggiavi	sorpresa
festeggiare	sorpresa
festeggeremmo	sorpresa
festeggereste	sorpresa
festeggiavate	sorpresa
festeggerete	sorpresa
festeggerò	sorpresa
festeggiassimo	sorpresa
festeggerei	sorpresa
festeggiando	sorpresa
festeggiate	sorpresa
festeggiai	sorpresa
festeggiassi	sorpresa
festeggiarono	sorpresa
festeggeranno	sorpresa
festeggiava	sorpresa
festeggerai	sorpresa
festeggiante	sorpresa
festeggia	sorpresa
festeggiaste	sorpresa
sbigottisse	sorpresa
sbigottendo	sorpresa
sbigottirei	sorpresa
sbigottiste	sorpresa
sbigottivi	sorpresa
sbigottirai	sorpresa
sbigottissimo	sorpresa
sbigottite	sorpresa
sbigottiscano	sorpresa
sbigottivate	sorpresa
sbigottirà	sorpresa
sbigottiscono	sorpresa
sbigottiranno	sorpresa
sbigottiamo	sorpresa
sbigottì	sorpresa
sbigottisco	sorpresa
sbigottirete	sorpresa
sbigottisci	sorpresa
sbigottii	sorpresa
sbigottisti	sorpresa
sbigottiva	sorpresa
sbigottente	sorpresa
sbigottisca	sorpresa
sbigottivano	sorpresa
sbigottissi	sorpresa
sbigottivo	sorpresa
sbigottimmo	sorpresa
sbigottirebbero	sorpresa
sbigottiate	sorpresa
sbigottiremo	sorpresa
sbigottiremmo	sorpresa
sbigottirò	sorpresa
sbigottisce	sorpresa
sbigottivamo	sorpresa
sbigottirebbe	sorpresa
sbigottir	sorpresa
sbigottissero	sorpresa
sbigottito	sorpresa
sbigottire	sorpresa
sbigottiti	sorpresa
sbigottiresti	sorpresa
sbigottita	sorpresa
sbigottirono	sorpresa
sbigottireste	sorpresa
sbigottenti	sorpresa
improvvise	sorpresa
improvviso	sorpresa
improvvisa	sorpresa
improvvisi	sorpresa
impreviste	sorpresa
imprevisto	sorpresa
imprevista	sorpresa
imprevisti	sorpresa
trasaliva	sorpresa
trasalissimo	sorpresa
trasaliste	sorpresa
trasalireste	sorpresa
trasalirò	sorpresa
trasalirebbe	sorpresa
trasalisse	sorpresa
trasalivate	sorpresa
trasaliresti	sorpresa
trasalì	sorpresa
trasaliscano	sorpresa
trasalirete	sorpresa
trasalendo	sorpresa
trasalivi	sorpresa
trasaliscono	sorpresa
trasalirei	sorpresa
trasalente	sorpresa
trasalirà	sorpresa
trasaliremmo	sorpresa
trasalire	sorpresa
trasalirono	sorpresa
trasalisti	sorpresa
trasalenti	sorpresa
trasalisci	sorpresa
trasaliranno	sorpresa
trasalisco	sorpresa
trasaliate	sorpresa
trasalite	sorpresa
trasalir	sorpresa
trasalissi	sorpresa
trasalirebbero	sorpresa
trasaliti	sorpresa
trasalimmo	sorpresa
trasalita	sorpresa
trasalirai	sorpresa
trasalisca	sorpresa
trasalito	sorpresa
trasalivo	sorpresa
trasalii	sorpresa
trasaliamo	sorpresa
trasalisce	sorpresa
trasalivamo	sorpresa
trasalivano	sorpresa
trasaliremo	sorpresa
trasalissero	sorpresa
contentezze	sorpresa
contentezza	sorpresa
luce	sorpresa
luci	sorpresa
impensata	sorpresa
impensato	sorpresa
impensati	sorpresa
impensate	sorpresa
gioiosi	sorpresa
gioiosetti	sorpresa
gioiosaccie	sorpresa
gioiosette	sorpresa
gioiosaccia	sorpresa
gioioso	sorpresa
gioiosissimo	sorpresa
gioiosissime	sorpresa
gioiosino	sorpresa
gioiosini	sorpresa
gioiosetto	sorpresa
gioiosaccii	sorpresa
gioiosaccio	sorpresa
gioiose	sorpresa
gioiosine	sorpresa
gioiosissima	sorpresa
gioiosina	sorpresa
gioiosetta	sorpresa
gioiosissimi	sorpresa
gioiosa	sorpresa
stupirò	sorpresa
stupir	sorpresa
stupirete	sorpresa
stupivate	sorpresa
stupissero	sorpresa
stupimmo	sorpresa
stupisce	sorpresa
stupivi	sorpresa
stupissi	sorpresa
stupiremo	sorpresa
stupire	sorpresa
stupirebbero	sorpresa
stupirai	sorpresa
stupirà	sorpresa
stupite	sorpresa
stupita	sorpresa
stupirono	sorpresa
stupiste	sorpresa
stupirei	sorpresa
stupiscono	sorpresa
stupivamo	sorpresa
stupì	sorpresa
stupenti	sorpresa
stupente	sorpresa
stupivano	sorpresa
stupito	sorpresa
stupiremmo	sorpresa
stupisca	sorpresa
stupii	sorpresa
stupisse	sorpresa
stupiamo	sorpresa
stupiranno	sorpresa
stupendo	sorpresa
stupiate	sorpresa
stupireste	sorpresa
stupiscano	sorpresa
stupiva	sorpresa
stupisci	sorpresa
stupiti	sorpresa
stupivo	sorpresa
stupisti	sorpresa
stupissimo	sorpresa
stupisco	sorpresa
stupirebbe	sorpresa
stupiresti	sorpresa
regalerà	sorpresa
regalerete	sorpresa
regalano	sorpresa
regalassimo	sorpresa
regalaste	sorpresa
regalando	sorpresa
regaliamo	sorpresa
regalarono	sorpresa
regalante	sorpresa
regalerai	sorpresa
regalò	sorpresa
regalavo	sorpresa
regalereste	sorpresa
regalata	sorpresa
regaleresti	sorpresa
regalate	sorpresa
regalavate	sorpresa
regalavano	sorpresa
regalare	sorpresa
regala	sorpresa
regaleranno	sorpresa
regalerei	sorpresa
regali	sorpresa
regalerebbero	sorpresa
regalammo	sorpresa
regalino	sorpresa
regalai	sorpresa
regaliate	sorpresa
regalato	sorpresa
regalava	sorpresa
regalavamo	sorpresa
regalerebbe	sorpresa
regalavi	sorpresa
regalassi	sorpresa
regalar	sorpresa
regaleremmo	sorpresa
regaleremo	sorpresa
regalati	sorpresa
regalo	sorpresa
regalanti	sorpresa
regalasti	sorpresa
regalerò	sorpresa
regalasse	sorpresa
regalassero	sorpresa
inattesa	sorpresa
inattesi	sorpresa
inatteso	sorpresa
inattese	sorpresa
imprevedibile	sorpresa
imprevedibili	sorpresa
emozionati	sorpresa
emozionato	sorpresa
emozionate	sorpresa
emozionata	sorpresa
ringraziasti	sorpresa
ringrazia	sorpresa
ringraziammo	sorpresa
ringraziassero	sorpresa
ringraziare	sorpresa
ringrazieremo	sorpresa
ringrazino	sorpresa
ringraziando	sorpresa
ringrazierà	sorpresa
ringraziava	sorpresa
ringraziavi	sorpresa
ringraziavate	sorpresa
ringraziati	sorpresa
ringraziavo	sorpresa
ringrazierebbero	sorpresa
ringraziò	sorpresa
ringrazi	sorpresa
ringraziarono	sorpresa
ringraziereste	sorpresa
ringrazieremmo	sorpresa
ringraziavano	sorpresa
ringraziai	sorpresa
ringrazio	sorpresa
ringraziata	sorpresa
ringraziano	sorpresa
ringraziassimo	sorpresa
ringraziassi	sorpresa
ringraziante	sorpresa
ringraziavamo	sorpresa
ringrazierete	sorpresa
ringraziar	sorpresa
ringrazierai	sorpresa
ringraziate	sorpresa
ringraziasse	sorpresa
ringraziaste	sorpresa
ringrazieranno	sorpresa
ringraziamo	sorpresa
ringrazianti	sorpresa
ringrazierò	sorpresa
ringraziato	sorpresa
ringrazieresti	sorpresa
ringrazierei	sorpresa
ringrazierebbe	sorpresa
divertente	sorpresa
divertenti	sorpresa
divertentissimo	sorpresa
divertentissima	sorpresa
divertentissime	sorpresa
divertentissimi	sorpresa
sconcerti	sorpresa
sconcerto	sorpresa
sorprendesti	sorpresa
sorprenderà	sorpresa
sorprende	sorpresa
sorprenderebbero	sorpresa
sorprendereste	sorpresa
sorprendesse	sorpresa
sorprendete	sorpresa
sorprenderei	sorpresa
sorprendevi	sorpresa
sorprendevo	sorpresa
sorprendiamo	sorpresa
sorprenderanno	sorpresa
sorprendevate	sorpresa
sorprendevano	sorpresa
sorprendeste	sorpresa
sorprendenti	sorpresa
sorprendere	sorpresa
sorprendiate	sorpresa
sorprese	sorpresa
sorprendono	sorpresa
sorprendano	sorpresa
sorpresa	sorpresa
sorprenderemmo	sorpresa
sorprender	sorpresa
sorprenderai	sorpresa
sorprenderemo	sorpresa
sorprendente	sorpresa
sorprenda	sorpresa
sorprendessero	sorpresa
sorprendevamo	sorpresa
sorprendendo	sorpresa
sorpresero	sorpresa
sorpreso	sorpresa
sorprenderete	sorpresa
sorprendessimo	sorpresa
sorprendi	sorpresa
sorprenderebbe	sorpresa
sorprenderesti	sorpresa
sorprendo	sorpresa
sorprendessi	sorpresa
sorpresi	sorpresa
sorprendemmo	sorpresa
sorprenderò	sorpresa
sorprendeva	sorpresa
allontanato	disgusto
allontanate	disgusto
allontanata	disgusto
allontanati	disgusto
esecravate	disgusto
esecravamo	disgusto
esecrerai	disgusto
esecrante	disgusto
esecrò	disgusto
esecrati	disgusto
esecravo	disgusto
esecrando	disgusto
esecriamo	disgusto
esecrano	disgusto
esecriate	disgusto
esecrassero	disgusto
esecrassimo	disgusto
esecrava	disgusto
esecro	disgusto
esecrasti	disgusto
esecri	disgusto
esecreremo	disgusto
esecrassi	disgusto
esecrarono	disgusto
esecrata	disgusto
esecrato	disgusto
esecrasse	disgusto
esecravi	disgusto
esecrerebbero	disgusto
esecra	disgusto
esecrare	disgusto
esecrammo	disgusto
esecrerei	disgusto
esecreresti	disgusto
esecrerete	disgusto
esecrate	disgusto
esecrerà	disgusto
esecrerò	disgusto
esecranti	disgusto
esecrai	disgusto
esecreranno	disgusto
esecrereste	disgusto
esecrerebbe	disgusto
esecraste	disgusto
esecravano	disgusto
esecreremmo	disgusto
esecrino	disgusto
esecrar	disgusto
antipatico	disgusto
antipatiche	disgusto
antipatica	disgusto
antipatici	disgusto
sfiduciato	disgusto
sfiduciati	disgusto
sfiduciata	disgusto
sfiduciate	disgusto
rifiuteresti	disgusto
rifiuterebbero	disgusto
rifiuti	disgusto
rifiutante	disgusto
rifiuteremmo	disgusto
rifiutò	disgusto
rifiutata	disgusto
rifiutassero	disgusto
rifiuterai	disgusto
rifiutereste	disgusto
rifiutai	disgusto
rifiutavo	disgusto
rifiutassi	disgusto
rifiutare	disgusto
rifiuteremo	disgusto
rifiuto	disgusto
rifiutavamo	disgusto
rifiutanti	disgusto
rifiutiate	disgusto
rifiutava	disgusto
rifiutavi	disgusto
rifiuterete	disgusto
rifiutano	disgusto
rifiutarono	disgusto
rifiutavate	disgusto
rifiutar	disgusto
rifiuteranno	disgusto
rifiutate	disgusto
rifiuterò	disgusto
rifiuterà	disgusto
rifiutiamo	disgusto
rifiutammo	disgusto
rifiutino	disgusto
rifiuterebbe	disgusto
rifiutasse	disgusto
rifiutassimo	disgusto
rifiutasti	disgusto
rifiutaste	disgusto
rifiutato	disgusto
rifiutando	disgusto
rifiuterei	disgusto
rifiutavano	disgusto
rifiuta	disgusto
rifiutati	disgusto
verme	disgusto
vermi	disgusto
ripugnaste	disgusto
ripugna	disgusto
ripugnerei	disgusto
ripugnavate	disgusto
ripugnassero	disgusto
ripugnerai	disgusto
ripugniamo	disgusto
ripugnereste	disgusto
ripugnerebbero	disgusto
ripugneranno	disgusto
ripugniate	disgusto
ripugnerete	disgusto
ripugnino	disgusto
ripugnerebbe	disgusto
ripugnasti	disgusto
ripugnerà	disgusto
ripugnando	disgusto
ripugnassi	disgusto
ripugnavano	disgusto
ripugni	disgusto
ripugnerò	disgusto
ripugnano	disgusto
ripugnanti	disgusto
ripugnavo	disgusto
ripugnò	disgusto
ripugnato	disgusto
ripugnasse	disgusto
ripugno	disgusto
ripugneresti	disgusto
ripugnante	disgusto
ripugnarono	disgusto
ripugneremo	disgusto
ripugnavamo	disgusto
ripugnata	disgusto
ripugnare	disgusto
ripugnar	disgusto
ripugnavi	disgusto
ripugnai	disgusto
ripugnammo	disgusto
ripugnassimo	disgusto
ripugnava	disgusto
ripugnati	disgusto
ripugnate	disgusto
ripugneremmo	disgusto
falsa	disgusto
falsino	disgusto
falsaccio	disgusto
falsissime	disgusto
falsi	disgusto
falsaccii	disgusto
falsaccie	disgusto
falsetto	disgusto
falsette	disgusto
falsissimo	disgusto
falsissimi	disgusto
falsini	disgusto
falsaccia	disgusto
falsetti	disgusto
FALSE	disgusto
falsetta	disgusto
falsine	disgusto
falsissima	disgusto
falso	disgusto
falsina	disgusto
fastidiosissimo	disgusto
fastidiose	disgusto
fastidiosina	disgusto
fastidiosetta	disgusto
fastidiosaccii	disgusto
fastidiosissimi	disgusto
fastidiosaccie	disgusto
fastidiosaccia	disgusto
fastidiosissime	disgusto
fastidiosetto	disgusto
fastidiosini	disgusto
fastidiosaccio	disgusto
fastidiosino	disgusto
fastidiosi	disgusto
fastidiosissima	disgusto
fastidiosa	disgusto
fastidioso	disgusto
fastidiosine	disgusto
fastidiosette	disgusto
fastidiosetti	disgusto
vomito	disgusto
vomiti	disgusto
disgustano	disgusto
disgustati	disgusto
disgustassimo	disgusto
disgusterai	disgusto
disgusterei	disgusto
disgustammo	disgusto
disgustato	disgusto
disgusto	disgusto
disgusteresti	disgusto
disgusti	disgusto
disgustanti	disgusto
disgustavano	disgusto
disgusterà	disgusto
disgustare	disgusto
disgusterete	disgusto
disgustando	disgusto
disgustassero	disgusto
disgusteranno	disgusto
disgustò	disgusto
disgustaste	disgusto
disgusteremo	disgusto
disgustassi	disgusto
disgustata	disgusto
disgustate	disgusto
disgustino	disgusto
disgustavamo	disgusto
disgusta	disgusto
disgustarono	disgusto
disgustasti	disgusto
disgustiamo	disgusto
disgustai	disgusto
disgustavi	disgusto
disgustiate	disgusto
disgustereste	disgusto
disgustava	disgusto
disgustavo	disgusto
disgustante	disgusto
disgustavate	disgusto
disgusterò	disgusto
disgusterebbe	disgusto
disgustasse	disgusto
disgustar	disgusto
disgusterebbero	disgusto
disgusteremmo	disgusto
fetido	disgusto
fetidi	disgusto
fetide	disgusto
fetida	disgusto
avversione	disgusto
avversioni	disgusto
respingeresti	disgusto
respingesse	disgusto
respingessi	disgusto
respingevi	disgusto
respingesti	disgusto
respingevate	disgusto
respingerei	disgusto
respinsero	disgusto
respingevo	disgusto
respingerai	disgusto
respingerò	disgusto
respingo	disgusto
respingeremmo	disgusto
respingete	disgusto
respingeremo	disgusto
respinga	disgusto
respingerebbero	disgusto
respingevamo	disgusto
respingerete	disgusto
respingessimo	disgusto
respinger	disgusto
respingereste	disgusto
respingendo	disgusto
respingerà	disgusto
respingiate	disgusto
respingeva	disgusto
respingiamo	disgusto
respingenti	disgusto
respinte	disgusto
respingemmo	disgusto
respingeranno	disgusto
respinta	disgusto
respingeste	disgusto
respinto	disgusto
respingano	disgusto
respinge	disgusto
respingono	disgusto
respinsi	disgusto
respinti	disgusto
respingerebbe	disgusto
respingevano	disgusto
respingi	disgusto
respinse	disgusto
respingere	disgusto
respingente	disgusto
respingessero	disgusto
nausee	disgusto
nausea	disgusto
nauseabondo	disgusto
nauseabondi	disgusto
nauseabonde	disgusto
nauseabonda	disgusto
odiosità	disgusto
voltastomachi	disgusto
voltastomaco	disgusto
abominio	disgusto
abomini	disgusto
schifate	disgusto
schifati	disgusto
schifata	disgusto
schifato	disgusto
vomitevolissima	disgusto
vomitevolissimo	disgusto
vomitevolissimi	disgusto
vomitevoli	disgusto
vomitevole	disgusto
vomitevolissime	disgusto
sporcizia	disgusto
sporcizie	disgusto
nauseerebbero	disgusto
nauseata	disgusto
nauseavo	disgusto
nauseassero	disgusto
nauseassi	disgusto
nauseerà	disgusto
nauseassimo	disgusto
nauseavano	disgusto
nauseante	disgusto
nausei	disgusto
nauseerai	disgusto
nauseo	disgusto
nauseerei	disgusto
nauseeremo	disgusto
nauseiate	disgusto
nauseerete	disgusto
nauseavate	disgusto
nauseò	disgusto
nauseasse	disgusto
nauseare	disgusto
nausea	disgusto
nauseeremmo	disgusto
nauseereste	disgusto
nauseavamo	disgusto
nauseammo	disgusto
nauseati	disgusto
nauseava	disgusto
nauseano	disgusto
nauseanti	disgusto
nausearono	disgusto
nauseasti	disgusto
nauseerebbe	disgusto
nauseiamo	disgusto
nauseate	disgusto
nauseai	disgusto
nausear	disgusto
nauseeranno	disgusto
nauseavi	disgusto
nauseando	disgusto
nauseaste	disgusto
nauseeresti	disgusto
nauseerò	disgusto
nauseino	disgusto
nauseato	disgusto
amarini	disgusto
amarosetta	disgusto
amarine	disgusto
amaraccio	disgusto
amarissime	disgusto
amaraccia	disgusto
amari	disgusto
amaro	disgusto
amarosetti	disgusto
amara	disgusto
amare	disgusto
amarosetto	disgusto
amarissimo	disgusto
amarino	disgusto
amarissimi	disgusto
amaraccii	disgusto
amarosette	disgusto
amaraccie	disgusto
amarissima	disgusto
amarina	disgusto
pietosine	disgusto
pietosaccii	disgusto
pietosetto	disgusto
pietosini	disgusto
pietosaccie	disgusto
pietosissime	disgusto
pietosaccia	disgusto
pietosina	disgusto
pietosi	disgusto
pietosette	disgusto
pietosissima	disgusto
pietosaccio	disgusto
pietosa	disgusto
pietosino	disgusto
pietose	disgusto
pietosetti	disgusto
pietosetta	disgusto
pietoso	disgusto
pietosissimi	disgusto
pietosissimo	disgusto
indecenti	disgusto
indecente	disgusto
offenderebbe	disgusto
offenderà	disgusto
offendessimo	disgusto
offendiamo	disgusto
offendevano	disgusto
offendano	disgusto
offendendo	disgusto
offendere	disgusto
offesi	disgusto
offendevi	disgusto
offendessi	disgusto
offenderei	disgusto
offendevamo	disgusto
offender	disgusto
offende	disgusto
offenda	disgusto
offendereste	disgusto
offenderò	disgusto
offendesse	disgusto
offendente	disgusto
offesa	disgusto
offenderete	disgusto
offendesti	disgusto
offeso	disgusto
offendeste	disgusto
offese	disgusto
offenderebbero	disgusto
offenderemmo	disgusto
offenderesti	disgusto
offendeva	disgusto
offendete	disgusto
offendi	disgusto
offendenti	disgusto
offendemmo	disgusto
offenderemo	disgusto
offendevate	disgusto
offendono	disgusto
offesero	disgusto
offendessero	disgusto
offendevo	disgusto
offendo	disgusto
offenderanno	disgusto
offenderai	disgusto
offendiate	disgusto
disprezzeresti	disgusto
disprezzano	disgusto
disprezzavi	disgusto
disprezzato	disgusto
disprezzerebbero	disgusto
disprezzavamo	disgusto
disprezzanti	disgusto
disprezzavano	disgusto
disprezzereste	disgusto
disprezzò	disgusto
disprezzava	disgusto
disprezzar	disgusto
disprezzeremmo	disgusto
disprezzati	disgusto
disprezzerà	disgusto
disprezziamo	disgusto
disprezzino	disgusto
disprezzante	disgusto
disprezzassimo	disgusto
disprezziate	disgusto
disprezzerò	disgusto
disprezzasse	disgusto
disprezzaste	disgusto
disprezzassi	disgusto
disprezzata	disgusto
disprezzare	disgusto
disprezzeremo	disgusto
disprezzate	disgusto
disprezzasti	disgusto
disprezzeranno	disgusto
disprezzammo	disgusto
disprezzando	disgusto
disprezzavate	disgusto
disprezzerebbe	disgusto
disprezzavo	disgusto
disprezzerai	disgusto
disprezzerei	disgusto
disprezzi	disgusto
disprezzarono	disgusto
disprezzassero	disgusto
disprezza	disgusto
disprezzai	disgusto
disprezzerete	disgusto
disprezzo	disgusto
odori	disgusto
odore	disgusto
marcia	disgusto
marcio	disgusto
marcissimo	disgusto
marcissima	disgusto
marci	disgusto
marcissimi	disgusto
marce	disgusto
marcissime	disgusto
nauseante	disgusto
nauseantissime	disgusto
nauseantissimi	disgusto
nauseantissima	disgusto
nauseanti	disgusto
nauseantissimo	disgusto
pessime	disgusto
pessimo	disgusto
pessimi	disgusto
pessima	disgusto
repellenti	disgusto
repellente	disgusto
rivoltantissime	disgusto
rivoltantissimo	disgusto
rivoltantissima	disgusto
rivoltantissimi	disgusto
rivoltanti	disgusto
rivoltante	disgusto
odiosissime	disgusto
odiosaccii	disgusto
odiosissima	disgusto
odiosino	disgusto
odiosi	disgusto
odiosaccie	disgusto
odiose	disgusto
odiosetto	disgusto
odiosina	disgusto
odiosaccia	disgusto
odiosini	disgusto
odioso	disgusto
odiosine	disgusto
odiosetti	disgusto
odiosette	disgusto
odiosaccio	disgusto
odiosissimi	disgusto
odiosa	disgusto
odiosetta	disgusto
odiosissimo	disgusto
schifi	disgusto
schifo	disgusto
ipocrisie	disgusto
ipocrisia	disgusto
puzzato	disgusto
puzza	disgusto
puzzerete	disgusto
puzzai	disgusto
puzzante	disgusto
puzzata	disgusto
puzzi	disgusto
puzzava	disgusto
puzzavi	disgusto
puzzassi	disgusto
puzzeresti	disgusto
puzzassimo	disgusto
puzzammo	disgusto
puzzavate	disgusto
puzzaste	disgusto
puzzeranno	disgusto
puzzar	disgusto
puzzavano	disgusto
puzzerei	disgusto
puzzerai	disgusto
puzzate	disgusto
puzzino	disgusto
puzzavo	disgusto
puzzeremmo	disgusto
puzziate	disgusto
puzzanti	disgusto
puzzati	disgusto
puzzereste	disgusto
puzzano	disgusto
puzzeremo	disgusto
puzziamo	disgusto
puzzerebbe	disgusto
puzzasse	disgusto
puzzare	disgusto
puzzerò	disgusto
puzzerà	disgusto
puzzasti	disgusto
puzzò	disgusto
puzzarono	disgusto
puzzando	disgusto
puzzavamo	disgusto
puzzo	disgusto
puzzerebbero	disgusto
puzzassero	disgusto
schiferai	disgusto
schiferei	disgusto
schifanti	disgusto
schifai	disgusto
schifavate	disgusto
schiferemmo	disgusto
schifassero	disgusto
schifa	disgusto
schifò	disgusto
schifereste	disgusto
schiferebbe	disgusto
schifaste	disgusto
schifava	disgusto
schifata	disgusto
schiferò	disgusto
schifino	disgusto
schifano	disgusto
schifammo	disgusto
schifiamo	disgusto
schifar	disgusto
schifato	disgusto
schiferesti	disgusto
schifarono	disgusto
schifati	disgusto
schifasse	disgusto
schifasti	disgusto
schifavi	disgusto
schifassi	disgusto
schifavamo	disgusto
schifiate	disgusto
schiferete	disgusto
schifavo	disgusto
schiferà	disgusto
schifo	disgusto
schiferemo	disgusto
schiferanno	disgusto
schifi	disgusto
schifate	disgusto
schifando	disgusto
schifassimo	disgusto
schifavano	disgusto
schiferebbero	disgusto
schifante	disgusto
schifare	disgusto
resisterete	disgusto
resisterà	disgusto
resisti	disgusto
resisteranno	disgusto
resistè	disgusto
resista	disgusto
resiste	disgusto
resister	disgusto
resistesse	disgusto
resistevano	disgusto
resisto	disgusto
resistemmo	disgusto
resistessi	disgusto
resistendo	disgusto
resistito	disgusto
resistano	disgusto
resistessimo	disgusto
resisteva	disgusto
resisterono	disgusto
resistere	disgusto
resistevi	disgusto
resistente	disgusto
resisterebbero	disgusto
resistiti	disgusto
resisteste	disgusto
resistono	disgusto
resistiamo	disgusto
resisterò	disgusto
resistite	disgusto
resistereste	disgusto
resisteresti	disgusto
resistessero	disgusto
resisterebbe	disgusto
resistenti	disgusto
resistevamo	disgusto
resistete	disgusto
resisteremmo	disgusto
resistiate	disgusto
resistita	disgusto
resistevo	disgusto
resistesti	disgusto
resisterei	disgusto
resisteremo	disgusto
resistevate	disgusto
resistei	disgusto
resisterai	disgusto
restio	disgusto
restii	disgusto
respinta	disgusto
respinte	disgusto
respinti	disgusto
respinto	disgusto
evitavi	disgusto
evitassi	disgusto
evitassero	disgusto
evitavano	disgusto
evitasti	disgusto
evitando	disgusto
evitata	disgusto
evitai	disgusto
eviterò	disgusto
evitaste	disgusto
eviteresti	disgusto
eviterebbero	disgusto
eviterai	disgusto
eviterete	disgusto
eviterei	disgusto
evito	disgusto
evitarono	disgusto
evitava	disgusto
eviterebbe	disgusto
eviteremo	disgusto
evitati	disgusto
evitasse	disgusto
evitiamo	disgusto
evitereste	disgusto
evitò	disgusto
evitammo	disgusto
eviterà	disgusto
evitante	disgusto
evitate	disgusto
evitavamo	disgusto
evitare	disgusto
eviteremmo	disgusto
evitino	disgusto
evitano	disgusto
evitavate	disgusto
evitavo	disgusto
evitar	disgusto
evitiate	disgusto
evitassimo	disgusto
evitanti	disgusto
evitato	disgusto
eviti	disgusto
eviteranno	disgusto
evita	disgusto
repulsive	disgusto
repulsiva	disgusto
repulsivi	disgusto
repulsivo	disgusto
detestabilissima	disgusto
detestabilissime	disgusto
detestabile	disgusto
detestabili	disgusto
detestabilissimi	disgusto
detestabilissimo	disgusto
sangue	disgusto
sgradevole	disgusto
sgradevolissime	disgusto
sgradevolissimi	disgusto
sgradevolissima	disgusto
sgradevoli	disgusto
sgradevolissimo	disgusto
cibi	disgusto
cibo	disgusto
stomachevole	disgusto
stomachevolissime	disgusto
stomachevolissimi	disgusto
stomachevolissima	disgusto
stomachevolissimo	disgusto
stomachevoli	disgusto
ripugnantissima	disgusto
ripugnante	disgusto
ripugnantissimo	disgusto
ripugnanti	disgusto
ripugnantissime	disgusto
ripugnantissimi	disgusto
sputavamo	disgusto
sputata	disgusto
sputereste	disgusto
sputasse	disgusto
sputa	disgusto
sputassimo	disgusto
sputerai	disgusto
sputerebbero	disgusto
sputate	disgusto
sputante	disgusto
sputiamo	disgusto
sputerete	disgusto
sputiate	disgusto
sputerei	disgusto
sputerò	disgusto
sputarono	disgusto
sputar	disgusto
sputato	disgusto
sputati	disgusto
sputava	disgusto
sputammo	disgusto
sputeremmo	disgusto
sputando	disgusto
sputerà	disgusto
sputavate	disgusto
sputai	disgusto
sputeremo	disgusto
sputavi	disgusto
sputavano	disgusto
sputeranno	disgusto
sputi	disgusto
sputassi	disgusto
sputò	disgusto
sputanti	disgusto
sputerebbe	disgusto
sputasti	disgusto
sputassero	disgusto
sputare	disgusto
sputaste	disgusto
sputavo	disgusto
sputeresti	disgusto
sputano	disgusto
sputino	disgusto
sputo	disgusto
avverso	disgusto
avversi	disgusto
avversa	disgusto
avverse	disgusto
fetenti	disgusto
fetentissime	disgusto
fetentissima	disgusto
fetentissimi	disgusto
fetentissimo	disgusto
fetente	disgusto
allontaneresti	disgusto
allontanerà	disgusto
allontanata	disgusto
allontanavano	disgusto
allontanavi	disgusto
allontanando	disgusto
allontanassero	disgusto
allontanerebbe	disgusto
allontana	disgusto
allontanò	disgusto
allontanano	disgusto
allontaniamo	disgusto
allontanati	disgusto
allontaneremmo	disgusto
allontanavo	disgusto
allontanereste	disgusto
allontanino	disgusto
allontanar	disgusto
allontanavate	disgusto
allontanerai	disgusto
allontanammo	disgusto
allontanato	disgusto
allontanerete	disgusto
allontanate	disgusto
allontanare	disgusto
allontanerei	disgusto
allontani	disgusto
allontaneremo	disgusto
allontanava	disgusto
allontano	disgusto
allontanai	disgusto
allontanante	disgusto
allontanasse	disgusto
allontanassi	disgusto
allontanerebbero	disgusto
allontanerò	disgusto
allontanassimo	disgusto
allontanavamo	disgusto
allontaneranno	disgusto
allontaniate	disgusto
allontananti	disgusto
allontanasti	disgusto
allontanaste	disgusto
allontanarono	disgusto
rettile	disgusto
immangiabilissimi	disgusto
immangiabili	disgusto
immangiabilissimo	disgusto
immangiabile	disgusto
immangiabilissima	disgusto
immangiabilissime	disgusto
disdicevole	disgusto
disdicevolissime	disgusto
disdicevolissimi	disgusto
disdicevoli	disgusto
disdicevolissima	disgusto
disdicevolissimo	disgusto
disgustosini	disgusto
disgustosetto	disgusto
disgustosissimo	disgusto
disgustosina	disgusto
disgustosette	disgusto
disgustosetti	disgusto
disgustosi	disgusto
disgustoso	disgusto
disgustosaccii	disgusto
disgustosissime	disgusto
disgustosaccio	disgusto
disgustosissimi	disgusto
disgustosino	disgusto
disgustosissima	disgusto
disgustosetta	disgusto
disgustose	disgusto
disgustosaccia	disgusto
disgustosine	disgusto
disgustosaccie	disgusto
disgustosa	disgusto
marciume	disgusto
marciumi	disgusto
puzzolentissime	disgusto
puzzolentissimo	disgusto
puzzolenti	disgusto
puzzolente	disgusto
puzzolentissima	disgusto
puzzolentissimi	disgusto
provocherai	disgusto
provoco	disgusto
provocò	disgusto
provocassi	disgusto
provocammo	disgusto
provocaste	disgusto
provocati	disgusto
provocavano	disgusto
provocavo	disgusto
provocasse	disgusto
provocai	disgusto
provocar	disgusto
provocare	disgusto
provochi	disgusto
provocassimo	disgusto
provocasti	disgusto
provoca	disgusto
provocassero	disgusto
provocheresti	disgusto
provocheranno	disgusto
provocano	disgusto
provocava	disgusto
provocherebbe	disgusto
provocherei	disgusto
provocavamo	disgusto
provocheremmo	disgusto
provochino	disgusto
provochiamo	disgusto
provocando	disgusto
provocato	disgusto
provocavate	disgusto
provocherebbero	disgusto
provochereste	disgusto
provocavi	disgusto
provocante	disgusto
provocherete	disgusto
provocherà	disgusto
provocanti	disgusto
provocherò	disgusto
provocarono	disgusto
provochiate	disgusto
provocate	disgusto
provocheremo	disgusto
provocata	disgusto
esecrazioni	disgusto
esecrazione	disgusto
ripugnanza	disgusto
ripugnanze	disgusto
spiacevoli	disgusto
spiacevolissimo	disgusto
spiacevolissima	disgusto
spiacevolissime	disgusto
spiacevole	disgusto
spiacevolissimi	disgusto
abominevoli	disgusto
abominevole	disgusto
restio	disgusto
restie	disgusto
restia	disgusto
restii	disgusto
disgusto	disgusto
disgusti	disgusto
detestavo	disgusto
detestano	disgusto
detesti	disgusto
detestare	disgusto
detestammo	disgusto
detesta	disgusto
detestavano	disgusto
detesterete	disgusto
detestarono	disgusto
detesterei	disgusto
detestasti	disgusto
detesterebbero	disgusto
detestate	disgusto
detestava	disgusto
detestavamo	disgusto
detestavi	disgusto
detestò	disgusto
detestanti	disgusto
detesteremo	disgusto
detesteranno	disgusto
detesteresti	disgusto
detestiamo	disgusto
detestiate	disgusto
detestereste	disgusto
detestando	disgusto
detestasse	disgusto
detesteremmo	disgusto
detestino	disgusto
detestassimo	disgusto
detestati	disgusto
detestassi	disgusto
detesterai	disgusto
detestar	disgusto
detestai	disgusto
detesterà	disgusto
detestato	disgusto
detestavate	disgusto
detesterò	disgusto
detestante	disgusto
detestata	disgusto
detestassero	disgusto
detesto	disgusto
detesterebbe	disgusto
detestaste	disgusto
condanniamo	disgusto
condannassi	disgusto
condannasse	disgusto
condannati	disgusto
condannassimo	disgusto
condanno	disgusto
condannar	disgusto
condannanti	disgusto
condanna	disgusto
condannavano	disgusto
condannerai	disgusto
condanneremmo	disgusto
condannino	disgusto
condanneresti	disgusto
condannerei	disgusto
condannassero	disgusto
condannerebbe	disgusto
condannerete	disgusto
condanni	disgusto
condannata	disgusto
condannante	disgusto
condannato	disgusto
condannando	disgusto
condannavo	disgusto
condannavate	disgusto
condannammo	disgusto
condanniate	disgusto
condannaste	disgusto
condannasti	disgusto
condannarono	disgusto
condannavi	disgusto
condannereste	disgusto
condannai	disgusto
condannerà	disgusto
condannerebbero	disgusto
condannano	disgusto
condannavamo	disgusto
condannerò	disgusto
condannava	disgusto
condannare	disgusto
condannate	disgusto
condanneranno	disgusto
condannò	disgusto
condanneremo	disgusto
deprecabilissima	disgusto
deprecabile	disgusto
deprecabili	disgusto
deprecabilissime	disgusto
deprecabilissimo	disgusto
deprecabilissimi	disgusto
orrore	disgusto
orrori	disgusto
aborriscono	disgusto
aborrivo	disgusto
aborrir	disgusto
aborra	disgusto
aborrire	disgusto
aborrimmo	disgusto
aborriresti	disgusto
aborrirebbero	disgusto
aborrii	disgusto
aborrivano	disgusto
aborrirebbe	disgusto
aborrano	disgusto
aborriremo	disgusto
aborrisce	disgusto
aborriva	disgusto
aborrissi	disgusto
aborrisci	disgusto
aborriste	disgusto
aborrivamo	disgusto
aborrente	disgusto
aborrissero	disgusto
aborrirò	disgusto
aborriamo	disgusto
aborri	disgusto
aborriremmo	disgusto
aborrenti	disgusto
aborriranno	disgusto
aborrissimo	disgusto
aborriate	disgusto
aborro	disgusto
aborrirei	disgusto
aborrirà	disgusto
aborriti	disgusto
aborristi	disgusto
aborrisse	disgusto
aborrito	disgusto
aborrisco	disgusto
aborriscano	disgusto
aborrita	disgusto
aborrono	disgusto
aborrirai	disgusto
aborrireste	disgusto
aborrisca	disgusto
aborrivate	disgusto
aborrirono	disgusto
aborrendo	disgusto
aborrivi	disgusto
aborrì	disgusto
aborrirete	disgusto
aborrite	disgusto
aborre	disgusto
corrotti	disgusto
corrotte	disgusto
corrotto	disgusto
corrotta	disgusto
violentava	disgusto
violenterà	disgusto
violentassero	disgusto
violentanti	disgusto
violenterei	disgusto
violenteresti	disgusto
violentassi	disgusto
violentare	disgusto
violentarono	disgusto
violenti	disgusto
violentavano	disgusto
violentavo	disgusto
violentante	disgusto
violentammo	disgusto
violenterebbe	disgusto
violentasse	disgusto
violentino	disgusto
violentar	disgusto
violenteremmo	disgusto
violentata	disgusto
violenterai	disgusto
violentavi	disgusto
violentereste	disgusto
violentai	disgusto
violentasti	disgusto
violenta	disgusto
violenterete	disgusto
violentò	disgusto
violenterò	disgusto
violentano	disgusto
violentassimo	disgusto
violenterebbero	disgusto
violentaste	disgusto
violento	disgusto
violentavate	disgusto
violenteremo	disgusto
violentando	disgusto
violentiamo	disgusto
violenteranno	disgusto
violentati	disgusto
violentate	disgusto
violentiate	disgusto
violentavamo	disgusto
violentato	disgusto
infastidiranno	disgusto
infastidiremmo	disgusto
infastidivo	disgusto
infastidiva	disgusto
infastidirai	disgusto
infastidito	disgusto
infastidivano	disgusto
infastidimmo	disgusto
infastidiresti	disgusto
infastidita	disgusto
infastidireste	disgusto
infastidire	disgusto
infastidiste	disgusto
infastidirò	disgusto
infastiditi	disgusto
infastidisco	disgusto
infastidiremo	disgusto
infastidissero	disgusto
infastidissi	disgusto
infastidisca	disgusto
infastidiscono	disgusto
infastidisse	disgusto
infastidite	disgusto
infastidivate	disgusto
infastidenti	disgusto
infastidirebbe	disgusto
infastidì	disgusto
infastidirei	disgusto
infastidisci	disgusto
infastidir	disgusto
infastidivamo	disgusto
infastidisce	disgusto
infastidii	disgusto
infastidente	disgusto
infastidiate	disgusto
infastidivi	disgusto
infastidissimo	disgusto
infastidiscano	disgusto
infastidisti	disgusto
infastidirete	disgusto
infastidirà	disgusto
infastidendo	disgusto
infastidirebbero	disgusto
infastidirono	disgusto
infastidiamo	disgusto
puzzi	disgusto
puzzo	disgusto
vomitano	disgusto
vomitati	disgusto
vomitereste	disgusto
vomiti	disgusto
vomitiamo	disgusto
vomitando	disgusto
vomitassimo	disgusto
vomiteranno	disgusto
vomitai	disgusto
vomitassero	disgusto
vomitavate	disgusto
vomiterei	disgusto
vomitasse	disgusto
vomiterebbero	disgusto
vomiterò	disgusto
vomito	disgusto
vomitino	disgusto
vomiterete	disgusto
vomiterà	disgusto
vomitava	disgusto
vomitò	disgusto
vomitate	disgusto
vomiteremmo	disgusto
vomitasti	disgusto
vomita	disgusto
vomitaste	disgusto
vomitavano	disgusto
vomitavo	disgusto
vomiterebbe	disgusto
vomitammo	disgusto
vomitata	disgusto
vomitar	disgusto
vomitarono	disgusto
vomitato	disgusto
vomitavamo	disgusto
vomitante	disgusto
vomitavi	disgusto
vomiterai	disgusto
vomiteremo	disgusto
vomitare	disgusto
vomitiate	disgusto
vomitassi	disgusto
vomiteresti	disgusto
vomitanti	disgusto
intimidivi	paura
intimidiremo	paura
intimidirete	paura
intimidiamo	paura
intimidiscono	paura
intimidissero	paura
intimidiscano	paura
intimidiranno	paura
intimidisci	paura
intimidivano	paura
intimidita	paura
intimidire	paura
intimidì	paura
intimidissimo	paura
intimiditi	paura
intimidisco	paura
intimidiva	paura
intimidisti	paura
intimidirai	paura
intimidivate	paura
intimidirebbero	paura
intimidito	paura
intimidente	paura
intimidii	paura
intimidirebbe	paura
intimidirono	paura
intimidiremmo	paura
intimidirei	paura
intimidiste	paura
intimidisce	paura
intimidirà	paura
intimidimmo	paura
intimidireste	paura
intimidir	paura
intimidite	paura
intimidisca	paura
intimidiate	paura
intimidivo	paura
intimidirò	paura
intimidiresti	paura
intimidenti	paura
intimidisse	paura
intimidissi	paura
intimidivamo	paura
intimidendo	paura
tremavano	paura
tremavamo	paura
tremassimo	paura
tremi	paura
tremerai	paura
tremino	paura
tremeresti	paura
tremassi	paura
tremano	paura
tremasse	paura
tremo	paura
trema	paura
tremata	paura
tremiamo	paura
tremaste	paura
tremare	paura
tremarono	paura
tremereste	paura
tremai	paura
tremasti	paura
tremerà	paura
tremeranno	paura
tremeremo	paura
tremate	paura
tremeremmo	paura
tremante	paura
tremanti	paura
tremava	paura
tremato	paura
tremavate	paura
tremiate	paura
tremati	paura
tremerei	paura
tremammo	paura
tremando	paura
tremerò	paura
tremar	paura
tremassero	paura
tremavi	paura
tremerebbero	paura
tremavo	paura
tremò	paura
tremerebbe	paura
tremerete	paura
tenebrosini	paura
tenebrosetta	paura
tenebrosette	paura
tenebrosissime	paura
tenebroso	paura
tenebrosino	paura
tenebrosaccie	paura
tenebrosissima	paura
tenebrosetto	paura
tenebrosissimi	paura
tenebrosina	paura
tenebrosa	paura
tenebrosaccia	paura
tenebrosi	paura
tenebrosine	paura
tenebrosissimo	paura
tenebrosaccii	paura
tenebrosaccio	paura
tenebrosetti	paura
tenebrose	paura
vigliacchi	paura
vigliacca	paura
vigliacco	paura
vigliacche	paura
impaurite	paura
impaurita	paura
impauriti	paura
impaurito	paura
scappar	paura
scappavi	paura
scappante	paura
scappo	paura
scapperebbe	paura
scappino	paura
scappata	paura
scappando	paura
scappasse	paura
scappammo	paura
scappa	paura
scappiamo	paura
scappava	paura
scappereste	paura
scapperemmo	paura
scappai	paura
scapperei	paura
scapperebbero	paura
scappi	paura
scapperai	paura
scappò	paura
scappassero	paura
scapperesti	paura
scappassi	paura
scappano	paura
scapparono	paura
scappiate	paura
scapperemo	paura
scappavano	paura
scappassimo	paura
scappanti	paura
scappavate	paura
scapperò	paura
scappavo	paura
scapperanno	paura
scappare	paura
scapperà	paura
scappaste	paura
scappati	paura
scappavamo	paura
scapperete	paura
scappato	paura
scappate	paura
scappasti	paura
angosciati	paura
angosciava	paura
angoscianti	paura
angoscerebbe	paura
angosciaste	paura
angosciare	paura
angosciata	paura
angosciano	paura
angoscino	paura
angosceresti	paura
angosciate	paura
angosciavate	paura
angoscerai	paura
angosciar	paura
angosciò	paura
angoscereste	paura
angosciai	paura
angosciante	paura
angosceranno	paura
angosciassi	paura
angosciasti	paura
angosceremmo	paura
angosciassero	paura
angoscerà	paura
angosciamo	paura
angoscio	paura
angoscia	paura
angosciavamo	paura
angoscerò	paura
angosciavano	paura
angoscerei	paura
angosciammo	paura
angosciavi	paura
angoscerete	paura
angosciasse	paura
angosceremo	paura
angosciavo	paura
angoscerebbero	paura
angosciato	paura
angosciassimo	paura
angosciando	paura
angosciarono	paura
angosci	paura
fughe	paura
fuga	paura
spavento	paura
spaventi	paura
fobici	paura
fobica	paura
fobiche	paura
fobico	paura
dubbiosaccia	paura
dubbiosette	paura
dubbiosina	paura
dubbiosino	paura
dubbiosissimo	paura
dubbiosaccio	paura
dubbiosetti	paura
dubbiosini	paura
dubbioso	paura
dubbiosissima	paura
dubbiosissimi	paura
dubbiosetta	paura
dubbiosa	paura
dubbiose	paura
dubbiosetto	paura
dubbiosaccie	paura
dubbiosine	paura
dubbiosissime	paura
dubbiosaccii	paura
dubbiosi	paura
agghiacciavamo	paura
agghiaccino	paura
agghiacciava	paura
agghiacciare	paura
agghiaccereste	paura
agghiacciavano	paura
agghiacciassimo	paura
agghiacciaste	paura
agghiacciammo	paura
agghiacciante	paura
agghiacciavo	paura
agghiaccerai	paura
agghiacciamo	paura
agghiacciano	paura
agghiacciarono	paura
agghiacciò	paura
agghiaccerà	paura
agghiaccerei	paura
agghiaccia	paura
agghiacciate	paura
agghiacciavate	paura
agghiacceremo	paura
agghiacciar	paura
agghiacceranno	paura
agghiacciato	paura
agghiacciavi	paura
agghiacciai	paura
agghiaccerete	paura
agghiacciasse	paura
agghiaccerò	paura
agghiacciata	paura
agghiacceresti	paura
agghiacciando	paura
agghiacciati	paura
agghiaccio	paura
agghiaccerebbe	paura
agghiacciassero	paura
agghiacciasti	paura
agghiaccianti	paura
agghiacciassi	paura
agghiacceremmo	paura
agghiaccerebbero	paura
agghiacci	paura
fobie	paura
fobia	paura
isterie	paura
isteria	paura
paure	paura
paura	paura
terribile	paura
terribili	paura
tremantissimo	paura
tremantissimi	paura
tremante	paura
tremantissime	paura
tremanti	paura
tremantissima	paura
tremendosetto	paura
tremendaccie	paura
tremendini	paura
tremendi	paura
tremendina	paura
tremendosette	paura
tremendaccia	paura
tremenda	paura
tremendissime	paura
tremendaccio	paura
tremendo	paura
tremendino	paura
tremende	paura
tremendaccii	paura
tremendissima	paura
tremendissimo	paura
tremendosetta	paura
tremendosetti	paura
tremendine	paura
tremendissimi	paura
serpente	paura
serpenti	paura
impressionerebbe	paura
impressionava	paura
impressiono	paura
impressionai	paura
impressionaste	paura
impressionassimo	paura
impressionando	paura
impressionano	paura
impressionavi	paura
impressionerebbero	paura
impressionerà	paura
impressionerai	paura
impressionarono	paura
impressionereste	paura
impressionerei	paura
impressionerete	paura
impressionassero	paura
impressioni	paura
impressioneranno	paura
impressionammo	paura
impressionate	paura
impressionante	paura
impressionasse	paura
impressionavamo	paura
impressionavate	paura
impressiona	paura
impressioneremmo	paura
impressioniate	paura
impressionassi	paura
impressionò	paura
impressioneresti	paura
impressionar	paura
impressionasti	paura
impressionavano	paura
impressionato	paura
impressioniamo	paura
impressionati	paura
impressionino	paura
impressionare	paura
impressionata	paura
impressionerò	paura
impressionavo	paura
impressioneremo	paura
impressionanti	paura
vile	paura
vili	paura
intimidazione	paura
intimidazioni	paura
brividi	paura
brivido	paura
terrore	paura
terrori	paura
smarrita	paura
smarrito	paura
smarriti	paura
smarrite	paura
spaventate	paura
spaventata	paura
spaventati	paura
spaventato	paura
impressionata	paura
impressionate	paura
impressionato	paura
impressionati	paura
paurose	paura
paurosine	paura
paurosaccii	paura
paurosissima	paura
paurosaccie	paura
paurosaccio	paura
paurosissimi	paura
paurosissimo	paura
paurosette	paura
paurosetti	paura
paurosa	paura
paurosino	paura
paurosissime	paura
paurosini	paura
pauroso	paura
paurosetto	paura
paurosina	paura
paurosi	paura
paurosaccia	paura
paurosetta	paura
allarmi	paura
allarme	paura
preoccupazioni	paura
preoccupazione	paura
spaventosissima	paura
spaventosaccii	paura
spaventosini	paura
spaventosetta	paura
spaventosetto	paura
spaventosetti	paura
spaventosina	paura
spaventosi	paura
spaventosette	paura
spaventosaccie	paura
spaventosa	paura
spaventosaccia	paura
spaventoso	paura
spaventosine	paura
spaventosissime	paura
spaventosino	paura
spaventosissimo	paura
spaventosissimi	paura
spaventosaccio	paura
spaventose	paura
miserie	paura
miseria	paura
terrorizzare	paura
terrorizzaste	paura
terrorizzerebbero	paura
terrorizzeresti	paura
terrorizzi	paura
terrorizziate	paura
terrorizzò	paura
terrorizzassimo	paura
terrorizzeranno	paura
terrorizzai	paura
terrorizzasti	paura
terrorizzerebbe	paura
terrorizzereste	paura
terrorizziamo	paura
terrorizzano	paura
terrorizzerai	paura
terrorizzassero	paura
terrorizzino	paura
terrorizzati	paura
terrorizzata	paura
terrorizzarono	paura
terrorizza	paura
terrorizzato	paura
terrorizzante	paura
terrorizzavamo	paura
terrorizzavate	paura
terrorizzeremo	paura
terrorizzeremmo	paura
terrorizzammo	paura
terrorizzando	paura
terrorizzavi	paura
terrorizzo	paura
terrorizzerete	paura
terrorizzanti	paura
terrorizzate	paura
terrorizzavano	paura
terrorizzavo	paura
terrorizzasse	paura
terrorizzerò	paura
terrorizzar	paura
terrorizzava	paura
terrorizzerei	paura
terrorizzassi	paura
terrorizzerà	paura
intimiditi	paura
intimidito	paura
intimidita	paura
intimidite	paura
ansiosa	paura
ansiosette	paura
ansiosetto	paura
ansiosaccia	paura
ansiosaccio	paura
ansiosissime	paura
ansiosini	paura
ansiosetta	paura
ansiosissima	paura
ansiosissimi	paura
ansiosissimo	paura
ansioso	paura
ansiosina	paura
ansiosaccie	paura
ansiosi	paura
ansiosine	paura
ansiose	paura
ansiosaccii	paura
ansiosino	paura
ansiosetti	paura
lasciai	paura
lascia	paura
lasciassero	paura
lasciando	paura
lasciava	paura
lasciante	paura
lasciare	paura
lasciate	paura
lasciassi	paura
lasciavi	paura
lasciarono	paura
lasceranno	paura
lasciar	paura
lasceremmo	paura
lasciassimo	paura
lasciavate	paura
lasciavano	paura
lascino	paura
lascereste	paura
lascianti	paura
lasciaste	paura
lascerebbero	paura
lascio	paura
lasciammo	paura
lasciati	paura
lasci	paura
lasciano	paura
lascerete	paura
lascerò	paura
lasciavo	paura
lasciamo	paura
lasciasti	paura
lasceresti	paura
lasciata	paura
lascerei	paura
lasciò	paura
lascerai	paura
lasceremo	paura
lascerà	paura
lasciavamo	paura
lascerebbe	paura
lasciasse	paura
lasciato	paura
agitati	paura
agitato	paura
agitate	paura
agitata	paura
preoccupanti	paura
preoccuperanno	paura
preoccuperà	paura
preoccupavate	paura
preoccupasse	paura
preoccupo	paura
preoccupasti	paura
preoccupati	paura
preoccupino	paura
preoccupi	paura
preoccupando	paura
preoccupa	paura
preoccupavano	paura
preoccupavo	paura
preoccupammo	paura
preoccuperei	paura
preoccupiate	paura
preoccupai	paura
preoccupar	paura
preoccupavamo	paura
preoccupaste	paura
preoccuperesti	paura
preoccuperemmo	paura
preoccuperai	paura
preoccupata	paura
preoccupiamo	paura
preoccuparono	paura
preoccupate	paura
preoccupare	paura
preoccuperò	paura
preoccupò	paura
preoccuperemo	paura
preoccuperebbero	paura
preoccuperebbe	paura
preoccupassi	paura
preoccupano	paura
preoccupereste	paura
preoccuperete	paura
preoccupato	paura
preoccupante	paura
preoccupava	paura
preoccupavi	paura
preoccupassimo	paura
preoccupassero	paura
apprensivo	paura
apprensive	paura
apprensivosetti	paura
apprensivine	paura
apprensiva	paura
apprensivosette	paura
apprensivissima	paura
apprensivosetta	paura
apprensivissimi	paura
apprensivissime	paura
apprensivaccii	paura
apprensivina	paura
apprensivosetto	paura
apprensivaccio	paura
apprensivini	paura
apprensivissimo	paura
apprensivi	paura
apprensivaccia	paura
apprensivino	paura
apprensivaccie	paura
atterrì	paura
atterrisca	paura
atterrirebbe	paura
atterrisci	paura
atterrivamo	paura
atterriremo	paura
atterrissimo	paura
atterrirono	paura
atterriremmo	paura
atterrisco	paura
atterrisce	paura
atterrii	paura
atterrivate	paura
atterrire	paura
atterrivano	paura
atterriste	paura
atterrirei	paura
atterrirà	paura
atterrite	paura
atterrenti	paura
atterriranno	paura
atterriti	paura
atterriva	paura
atterrito	paura
atterristi	paura
atterrirebbero	paura
atterriresti	paura
atterrirò	paura
atterriscono	paura
atterrissi	paura
atterrivo	paura
atterrendo	paura
atterrissero	paura
atterrimmo	paura
atterrivi	paura
atterrirai	paura
atterrisse	paura
atterrireste	paura
atterrirete	paura
atterrir	paura
atterriscano	paura
atterrita	paura
atterrente	paura
atterrite	paura
atterrita	paura
atterriti	paura
atterrito	paura
rabbrividissi	paura
rabbrividisci	paura
rabbrividiate	paura
rabbrividiste	paura
rabbrividiscano	paura
rabbrividenti	paura
rabbrividirete	paura
rabbrividiamo	paura
rabbrividivano	paura
rabbrividivi	paura
rabbrividisce	paura
rabbrividir	paura
rabbrividendo	paura
rabbrividivate	paura
rabbrividiva	paura
rabbrividiremo	paura
rabbrividita	paura
rabbrividiremmo	paura
rabbrividirebbe	paura
rabbrividirebbero	paura
rabbrividito	paura
rabbrividirono	paura
rabbrividireste	paura
rabbrividirò	paura
rabbrividiscono	paura
rabbrividente	paura
rabbrividivo	paura
rabbrividissimo	paura
rabbrividisca	paura
rabbrividirei	paura
rabbrividisse	paura
rabbrividiti	paura
rabbrividirà	paura
rabbrividisti	paura
rabbrividiranno	paura
rabbrividisco	paura
rabbrividimmo	paura
rabbrividissero	paura
rabbrividire	paura
rabbrividì	paura
rabbrividirai	paura
rabbrividiresti	paura
rabbrividivamo	paura
rabbrividii	paura
rabbrividite	paura
agghiacciati	paura
agghiacciato	paura
agghiacciate	paura
agghiacciata	paura
ignoti	paura
ignote	paura
ignota	paura
ignoto	paura
timore	paura
timori	paura
sinistre	paura
sinistra	paura
sinistro	paura
sinistri	paura
smarriste	paura
smarriranno	paura
smarriremmo	paura
smarrirà	paura
smarrissero	paura
smarrente	paura
smarrita	paura
smarrivano	paura
smarrireste	paura
smarriti	paura
smarrite	paura
smarriresti	paura
smarriva	paura
smarrivate	paura
smarristi	paura
smarrì	paura
smarrissimo	paura
smarrirebbero	paura
smarrisca	paura
smarrisce	paura
smarrissi	paura
smarrirebbe	paura
smarrii	paura
smarrirò	paura
smarriremo	paura
smarrivo	paura
smarriamo	paura
smarrivi	paura
smarrito	paura
smarrirai	paura
smarrisci	paura
smarriate	paura
smarrire	paura
smarrendo	paura
smarrivamo	paura
smarrirete	paura
smarrenti	paura
smarrimmo	paura
smarrir	paura
smarrirei	paura
smarrirono	paura
smarrisco	paura
smarrisse	paura
smarriscono	paura
smarriscano	paura
panico	paura
panichi	paura
paventeremmo	paura
paventi	paura
paventerebbero	paura
paventò	paura
paventeresti	paura
paventassimo	paura
paventaste	paura
paventavi	paura
paventassi	paura
paventerete	paura
paventate	paura
paventerebbe	paura
paventiate	paura
paventerai	paura
paventassero	paura
paventata	paura
paventa	paura
paventasti	paura
paventavo	paura
paventavamo	paura
paventati	paura
paventino	paura
paventarono	paura
paventai	paura
paventavano	paura
paventeremo	paura
paventerà	paura
paventereste	paura
paventare	paura
paventando	paura
paventasse	paura
paventano	paura
paventava	paura
paventiamo	paura
paventerei	paura
paventavate	paura
paventanti	paura
paventerò	paura
paventante	paura
paventar	paura
paventeranno	paura
paventato	paura
paventammo	paura
pavento	paura
dannosaccii	paura
dannosette	paura
dannosina	paura
dannosaccie	paura
dannosaccio	paura
dannosissima	paura
dannose	paura
dannosetti	paura
dannosissimo	paura
dannosissime	paura
dannosaccia	paura
dannosissimi	paura
dannosa	paura
dannosetta	paura
dannoso	paura
dannosini	paura
dannosi	paura
dannosino	paura
dannosine	paura
dannosetto	paura
spaurite	paura
spaurito	paura
spaurita	paura
spauriti	paura
sgomentante	paura
sgomentava	paura
sgomentavate	paura
sgomenterebbe	paura
sgomentavano	paura
sgomentarono	paura
sgomentai	paura
sgomenterete	paura
sgomentare	paura
sgomentavi	paura
sgomentaste	paura
sgomentino	paura
sgomentiate	paura
sgomentar	paura
sgomento	paura
sgomentata	paura
sgomentato	paura
sgomentassimo	paura
sgomentammo	paura
sgomentando	paura
sgomentasse	paura
sgomentano	paura
sgomenterebbero	paura
sgomenti	paura
sgomenteremo	paura
sgomentati	paura
sgomentò	paura
sgomentate	paura
sgomentassi	paura
sgomentavamo	paura
sgomenterò	paura
sgomentasti	paura
sgomenterai	paura
sgomenterei	paura
sgomentereste	paura
sgomenteresti	paura
sgomentassero	paura
sgomenta	paura
sgomenterà	paura
sgomenteremmo	paura
sgomentiamo	paura
sgomenteranno	paura
sgomentavo	paura
sgomentanti	paura
tema	paura
temereste	paura
temete	paura
temerai	paura
temei	paura
temere	paura
temevate	paura
temesti	paura
temerebbe	paura
temerebbero	paura
temerete	paura
temente	paura
temevo	paura
temeranno	paura
temiamo	paura
temessi	paura
temè	paura
temevano	paura
temuta	paura
temuti	paura
temeremo	paura
temer	paura
tementi	paura
teme	paura
temevamo	paura
temiate	paura
temeste	paura
temono	paura
temute	paura
temessimo	paura
temessero	paura
temerà	paura
temendo	paura
temeresti	paura
temesse	paura
tememmo	paura
temo	paura
temano	paura
temerei	paura
temeremmo	paura
temerono	paura
temeva	paura
temuto	paura
temi	paura
temevi	paura
temerò	paura
timorosissimo	paura
timoroso	paura
timorosa	paura
timorosetti	paura
timorosaccie	paura
timorosissime	paura
timorosaccii	paura
timorosini	paura
timorosette	paura
timorosine	paura
timorosaccia	paura
timorosetto	paura
timorosaccio	paura
timorose	paura
timorosetta	paura
timorosina	paura
timorosino	paura
timorosissima	paura
timorosi	paura
timorosissimi	paura
spettrale	paura
spettrali	paura
terrificassimo	paura
terrificando	paura
terrificarono	paura
terrificata	paura
terrificassero	paura
terrificassi	paura
terrificasti	paura
terrificheranno	paura
terrificato	paura
terrificherei	paura
terrifichiate	paura
terrificano	paura
terrificheresti	paura
terrificare	paura
terrifichiamo	paura
terrificherà	paura
terrificava	paura
terrificherete	paura
terrificavi	paura
terrificavo	paura
terrifica	paura
terrifichereste	paura
terrificante	paura
terrificò	paura
terrificheremmo	paura
terrificheremo	paura
terrificanti	paura
terrificar	paura
terrifico	paura
terrifichi	paura
terrificati	paura
terrifichino	paura
terrificammo	paura
terrificai	paura
terrificherò	paura
terrificaste	paura
terrificherebbero	paura
terrificherebbe	paura
terrificate	paura
terrificasse	paura
terrificavano	paura
terrificavamo	paura
terrificherai	paura
terrificavate	paura
tristezza	paura
tristezze	paura
strizza	paura
strizze	paura
raccapricciantissime	paura
raccapricciantissimo	paura
raccapriccianti	paura
raccapricciante	paura
raccapricciantissimi	paura
raccapricciantissima	paura
orrendo	paura
orrende	paura
orrendi	paura
orrenda	paura
affrontino	paura
affrontavamo	paura
affrontanti	paura
affronteranno	paura
affronti	paura
affrontando	paura
affrontiate	paura
affronta	paura
affronteremmo	paura
affrontammo	paura
affrontiamo	paura
affrontai	paura
affrontate	paura
affrontata	paura
affrontarono	paura
affrontasti	paura
affronterai	paura
affronterete	paura
affronterebbero	paura
affronterò	paura
affrontati	paura
affrontassero	paura
affrontassimo	paura
affrontasse	paura
affrontereste	paura
affronterebbe	paura
affrontavano	paura
affrontaste	paura
affrontare	paura
affrontava	paura
affronterei	paura
affronteremo	paura
affrontò	paura
affronteresti	paura
affrontato	paura
affrontassi	paura
affronto	paura
affrontavi	paura
affrontavate	paura
affrontante	paura
affronterà	paura
affrontavo	paura
affrontano	paura
affrontar	paura
allarmate	paura
allarmato	paura
allarmati	paura
allarmata	paura
pericoli	paura
pericolo	paura
indecisi	paura
indecisa	paura
indeciso	paura
indecise	paura
preoccupate	paura
preoccupata	paura
preoccupati	paura
preoccupato	paura
spaventeresti	paura
spaventarono	paura
spaventeranno	paura
spaventerà	paura
spaventanti	paura
spaventiamo	paura
spaventerebbe	paura
spaventeremo	paura
spavento	paura
spaventate	paura
spaventeremmo	paura
spaventasse	paura
spaventerai	paura
spaventavano	paura
spaventammo	paura
spaventante	paura
spaventano	paura
spaventerei	paura
spaventata	paura
spaventassero	paura
spaventerebbero	paura
spaventavi	paura
spaventavamo	paura
spaventando	paura
spaventa	paura
spaventati	paura
spaventò	paura
spaventi	paura
spaventai	paura
spaventasti	paura
spaventavate	paura
spaventaste	paura
spaventerò	paura
spaventiate	paura
spaventare	paura
spaventava	paura
spaventavo	paura
spaventar	paura
spaventato	paura
spaventerete	paura
spaventassi	paura
spaventereste	paura
spaventino	paura
spaventassimo	paura
oscuro	paura
oscurissimi	paura
oscuraccia	paura
oscure	paura
oscurino	paura
oscurine	paura
oscurissimo	paura
oscuraccii	paura
oscurosetta	paura
oscurosette	paura
oscuraccio	paura
oscurini	paura
oscuraccie	paura
oscuri	paura
oscura	paura
oscurina	paura
oscurosetto	paura
oscurosetti	paura
oscurissime	paura
oscurissima	paura
insicure	paura
insicuri	paura
insicuro	paura
insicura	paura
sgomento	paura
sgomenti	paura
supera	paura
superate	paura
supereranno	paura
superavate	paura
supererebbero	paura
superi	paura
superare	paura
supererei	paura
supereremo	paura
superai	paura
superassero	paura
superammo	paura
superar	paura
superante	paura
superereste	paura
supererebbe	paura
supererà	paura
superavamo	paura
supereresti	paura
supereremmo	paura
superaste	paura
superavano	paura
superasti	paura
superiate	paura
superiamo	paura
superarono	paura
superata	paura
supererai	paura
superino	paura
superò	paura
superato	paura
superava	paura
superanti	paura
superasse	paura
superavo	paura
supererete	paura
superavi	paura
superati	paura
supero	paura
superando	paura
superassi	paura
superassimo	paura
superano	paura
supererò	paura
triste	paura
tristissimi	paura
tristissime	paura
tristissima	paura
tristissimo	paura
tristi	paura
allarmassero	paura
allarmino	paura
allarmeremo	paura
allarmerebbe	paura
allarmava	paura
allarmo	paura
allarmiamo	paura
allarmare	paura
allarmavano	paura
allarmate	paura
allarmati	paura
allarmerò	paura
allarmasse	paura
allarmarono	paura
allarmavamo	paura
allarmasti	paura
allarmar	paura
allarma	paura
allarmereste	paura
allarmante	paura
allarmanti	paura
allarmavate	paura
allarmerai	paura
allarmeranno	paura
allarmano	paura
allarmato	paura
allarmeremmo	paura
allarmerà	paura
allarmavo	paura
allarmaste	paura
allarmammo	paura
allarmando	paura
allarmata	paura
allarmai	paura
allarmerei	paura
allarmerete	paura
allarmi	paura
allarmavi	paura
allarmassi	paura
allarmò	paura
allarmerebbero	paura
allarmeresti	paura
allarmiate	paura
allarmassimo	paura
codardini	paura
codarde	paura
codardo	paura
codardosetti	paura
codardaccii	paura
codardina	paura
codardaccio	paura
codardissime	paura
codardi	paura
codardosette	paura
codardosetta	paura
codardissimo	paura
codardino	paura
codardissimi	paura
codardine	paura
codardaccia	paura
codarda	paura
codardosetto	paura
codardaccie	paura
codardissima	paura
solini	tristezza
solaccio	tristezza
soli	tristezza
solino	tristezza
soline	tristezza
sola	tristezza
solaccia	tristezza
solina	tristezza
solosetta	tristezza
solo	tristezza
solissima	tristezza
solaccie	tristezza
solissimo	tristezza
solosetti	tristezza
sole	tristezza
solosetto	tristezza
solissime	tristezza
solissimi	tristezza
solaccii	tristezza
solosette	tristezza
depresso	tristezza
depressa	tristezza
depresse	tristezza
depressi	tristezza
intristite	tristezza
intristita	tristezza
intristiti	tristezza
intristito	tristezza
pene	tristezza
pena	tristezza
grigiori	tristezza
grigiore	tristezza
demoralizzazione	tristezza
demoralizzazioni	tristezza
insoddisfattosetto	tristezza
insoddisfattosetta	tristezza
insoddisfattine	tristezza
insoddisfatto	tristezza
insoddisfattaccie	tristezza
insoddisfattaccia	tristezza
insoddisfattaccii	tristezza
insoddisfatte	tristezza
insoddisfattissimi	tristezza
insoddisfatta	tristezza
insoddisfattina	tristezza
insoddisfattosetti	tristezza
insoddisfattosette	tristezza
insoddisfattaccio	tristezza
insoddisfattissime	tristezza
insoddisfatti	tristezza
insoddisfattino	tristezza
insoddisfattissima	tristezza
insoddisfattissimo	tristezza
insoddisfattini	tristezza
malinconiche	tristezza
malinconico	tristezza
malinconici	tristezza
malinconica	tristezza
piogge	tristezza
pioggia	tristezza
lutti	tristezza
lutto	tristezza
pesantezze	tristezza
pesantezza	tristezza
cinico	tristezza
ciniche	tristezza
cinica	tristezza
cinici	tristezza
intristireste	tristezza
intristirete	tristezza
intristissero	tristezza
intristivate	tristezza
intristiate	tristezza
intristisse	tristezza
intristiremo	tristezza
intristiscono	tristezza
intristiresti	tristezza
intristì	tristezza
intristimmo	tristezza
intristii	tristezza
intristissimo	tristezza
intristirebbero	tristezza
intristita	tristezza
intristivamo	tristezza
intristiva	tristezza
intristissi	tristezza
intristito	tristezza
intristivano	tristezza
intristirebbe	tristezza
intristirono	tristezza
intristite	tristezza
intristisci	tristezza
intrististi	tristezza
intristiamo	tristezza
intristisce	tristezza
intristiranno	tristezza
intristivi	tristezza
intristiscano	tristezza
intristir	tristezza
intristivo	tristezza
intristirei	tristezza
intristendo	tristezza
intrististe	tristezza
intristirò	tristezza
intristenti	tristezza
intristiti	tristezza
intristisco	tristezza
intristiremmo	tristezza
intristire	tristezza
intristirai	tristezza
intristirà	tristezza
intristisca	tristezza
intristente	tristezza
soffrissi	tristezza
soffrono	tristezza
soffrirebbe	tristezza
soffrirò	tristezza
soffrano	tristezza
soffrirebbero	tristezza
soffriresti	tristezza
soffriste	tristezza
soffrisse	tristezza
soffrii	tristezza
soffrissero	tristezza
soffriamo	tristezza
soffro	tristezza
soffrirei	tristezza
sofferente	tristezza
soffrendo	tristezza
soffrirai	tristezza
soffra	tristezza
soffrissimo	tristezza
soffri	tristezza
soffrivi	tristezza
sofferte	tristezza
soffriate	tristezza
soffrirà	tristezza
soffrite	tristezza
soffrir	tristezza
soffrivano	tristezza
soffrirete	tristezza
sofferti	tristezza
soffrivamo	tristezza
soffrivate	tristezza
soffrivo	tristezza
soffriranno	tristezza
soffrireste	tristezza
soffre	tristezza
soffrirono	tristezza
soffriva	tristezza
soffriremmo	tristezza
soffristi	tristezza
soffrimmo	tristezza
soffriremo	tristezza
sofferenti	tristezza
sofferta	tristezza
soffrì	tristezza
sofferto	tristezza
soffrire	tristezza
pianti	tristezza
pianto	tristezza
singhiozziate	tristezza
singhiozzeresti	tristezza
singhiozzaste	tristezza
singhiozzino	tristezza
singhiozzeranno	tristezza
singhiozzerò	tristezza
singhiozzerei	tristezza
singhiozza	tristezza
singhiozzando	tristezza
singhiozzavate	tristezza
singhiozzanti	tristezza
singhiozzavamo	tristezza
singhiozzate	tristezza
singhiozzavi	tristezza
singhiozzeremo	tristezza
singhiozzavano	tristezza
singhiozzasti	tristezza
singhiozzavo	tristezza
singhiozzi	tristezza
singhiozzassero	tristezza
singhiozzassi	tristezza
singhiozzerebbe	tristezza
singhiozzava	tristezza
singhiozzato	tristezza
singhiozzerebbero	tristezza
singhiozzeremmo	tristezza
singhiozzante	tristezza
singhiozzereste	tristezza
singhiozzarono	tristezza
singhiozzata	tristezza
singhiozzare	tristezza
singhiozziamo	tristezza
singhiozzano	tristezza
singhiozzammo	tristezza
singhiozzar	tristezza
singhiozzai	tristezza
singhiozzasse	tristezza
singhiozzati	tristezza
singhiozzerà	tristezza
singhiozzò	tristezza
singhiozzo	tristezza
singhiozzerai	tristezza
singhiozzassimo	tristezza
singhiozzerete	tristezza
fine	tristezza
mancanze	tristezza
mancanza	tristezza
malinconia	tristezza
malinconie	tristezza
rammaricata	tristezza
rammaricato	tristezza
rammaricati	tristezza
rammaricate	tristezza
mestizie	tristezza
mestizia	tristezza
dispiaciuto	tristezza
dispiaciute	tristezza
dispiaciuti	tristezza
dispiaciuta	tristezza
sofferta	tristezza
sofferti	tristezza
sofferte	tristezza
sofferto	tristezza
noiosine	tristezza
noiosetti	tristezza
noiosa	tristezza
noiosini	tristezza
noiosino	tristezza
noiosissime	tristezza
noiose	tristezza
noiosissimi	tristezza
noiosaccii	tristezza
noiosetto	tristezza
noiosina	tristezza
noiosissimo	tristezza
noioso	tristezza
noiosaccie	tristezza
noiosi	tristezza
noiosaccio	tristezza
noiosetta	tristezza
noiosette	tristezza
noiosaccia	tristezza
noiosissima	tristezza
inasprite	tristezza
inasprita	tristezza
inaspriti	tristezza
inasprito	tristezza
incupita	tristezza
incupite	tristezza
incupiti	tristezza
incupito	tristezza
avvilissero	tristezza
avvilimmo	tristezza
avvilì	tristezza
avvilirete	tristezza
avvilivo	tristezza
avvilivate	tristezza
avvilissi	tristezza
avvilirà	tristezza
avvilente	tristezza
avvilirò	tristezza
avvilendo	tristezza
avvilirono	tristezza
avviliscano	tristezza
avviliva	tristezza
avvilisti	tristezza
avvilire	tristezza
avviliranno	tristezza
avviliresti	tristezza
avvilenti	tristezza
avvilivano	tristezza
avviliremo	tristezza
avvilirebbe	tristezza
avvilisci	tristezza
avviliamo	tristezza
avvilite	tristezza
avvilisse	tristezza
avviliscono	tristezza
avvilirebbero	tristezza
avvilisce	tristezza
avvilivi	tristezza
avvilito	tristezza
avvilita	tristezza
avvilivamo	tristezza
avvilireste	tristezza
avvilirei	tristezza
avviliti	tristezza
avvilisca	tristezza
avvilir	tristezza
avvilisco	tristezza
avviliste	tristezza
avviliremmo	tristezza
avvilirai	tristezza
avvilii	tristezza
avvilissimo	tristezza
avviliate	tristezza
pesantissimi	tristezza
pesanti	tristezza
pesantissime	tristezza
pesante	tristezza
pesantissima	tristezza
pesantissimo	tristezza
incupirai	tristezza
incupiranno	tristezza
incupissi	tristezza
incupirei	tristezza
incupisco	tristezza
incupiscano	tristezza
incupiva	tristezza
incupirebbero	tristezza
incupirete	tristezza
incupisca	tristezza
incupiste	tristezza
incupivi	tristezza
incupimmo	tristezza
incupiscono	tristezza
incupirà	tristezza
incupirono	tristezza
incupita	tristezza
incupivo	tristezza
incupì	tristezza
incupirò	tristezza
incupisce	tristezza
incupenti	tristezza
incupiti	tristezza
incupisse	tristezza
incupii	tristezza
incupissero	tristezza
incupivano	tristezza
incupisci	tristezza
incupivamo	tristezza
incupisti	tristezza
incupite	tristezza
incupiremo	tristezza
incupirebbe	tristezza
incupiresti	tristezza
incupissimo	tristezza
incupireste	tristezza
incupivate	tristezza
incupiremmo	tristezza
incupito	tristezza
incupiamo	tristezza
incupente	tristezza
incupir	tristezza
incupiate	tristezza
incupendo	tristezza
incupire	tristezza
inaspriremmo	tristezza
inasprisse	tristezza
inasprirono	tristezza
inasprito	tristezza
inasprente	tristezza
inasprirebbero	tristezza
inaspristi	tristezza
inasprivate	tristezza
inasprir	tristezza
inasprii	tristezza
inasprivamo	tristezza
inasprì	tristezza
inaspriva	tristezza
inasprirò	tristezza
inasprisci	tristezza
inasprissimo	tristezza
inasprite	tristezza
inaspriamo	tristezza
inasprissero	tristezza
inaspriranno	tristezza
inasprivo	tristezza
inasprirebbe	tristezza
inaspriresti	tristezza
inasprirà	tristezza
inasprisco	tristezza
inaspriti	tristezza
inasprendo	tristezza
inaspriremo	tristezza
inaspriste	tristezza
inasprirete	tristezza
inasprivi	tristezza
inasprirai	tristezza
inaspriscano	tristezza
inasprimmo	tristezza
inasprissi	tristezza
inasprisca	tristezza
inaspriate	tristezza
inasprire	tristezza
inasprita	tristezza
inasprenti	tristezza
inasprirei	tristezza
inasprireste	tristezza
inasprisce	tristezza
inaspriscono	tristezza
inasprivano	tristezza
dispiacque	tristezza
dispiacerei	tristezza
dispiacerebbe	tristezza
dispiacessi	tristezza
dispiaccio	tristezza
dispiacenti	tristezza
dispiacete	tristezza
dispiacevano	tristezza
dispiacer	tristezza
dispiacquero	tristezza
dispiaciuti	tristezza
dispiacerò	tristezza
dispiacessimo	tristezza
dispiaciute	tristezza
dispiacqui	tristezza
dispiacessero	tristezza
dispiaceva	tristezza
dispiacevi	tristezza
dispiaceresti	tristezza
dispiaceremmo	tristezza
dispiacente	tristezza
dispiacesse	tristezza
dispiacemmo	tristezza
dispiacevamo	tristezza
dispiaciuta	tristezza
dispiacciamo	tristezza
dispiacendo	tristezza
dispiacerete	tristezza
dispiacciano	tristezza
dispiacevate	tristezza
dispiacciate	tristezza
dispiacerebbero	tristezza
dispiaccia	tristezza
dispiaci	tristezza
dispiacesti	tristezza
dispiacere	tristezza
dispiaceremo	tristezza
dispiacerà	tristezza
dispiacereste	tristezza
dispiaceste	tristezza
dispiace	tristezza
dispiaciuto	tristezza
dispiacevo	tristezza
dispiacciono	tristezza
dispiacerai	tristezza
dispiaceranno	tristezza
affliggiate	tristezza
affliggenti	tristezza
affliggerebbe	tristezza
affliggendo	tristezza
affliggerà	tristezza
affligger	tristezza
affliggevano	tristezza
affliggerete	tristezza
affliggono	tristezza
afflisse	tristezza
affliggessero	tristezza
affliggevo	tristezza
affliggevi	tristezza
afflissero	tristezza
afflissi	tristezza
affliggiamo	tristezza
affliggeranno	tristezza
affliggo	tristezza
affliggerei	tristezza
afflitte	tristezza
affliggesse	tristezza
affliggesti	tristezza
affliggessi	tristezza
affliggeste	tristezza
affliggere	tristezza
affliggerò	tristezza
affliggeva	tristezza
affliggeresti	tristezza
affliggano	tristezza
affliggessimo	tristezza
affliggevamo	tristezza
affligge	tristezza
affliggerebbero	tristezza
affliggemmo	tristezza
affliggi	tristezza
affliggerai	tristezza
affligga	tristezza
afflitto	tristezza
affliggente	tristezza
affliggete	tristezza
affliggevate	tristezza
afflitta	tristezza
affliggereste	tristezza
affliggeremo	tristezza
affliggeremmo	tristezza
afflitti	tristezza
indebolito	tristezza
indebolirà	tristezza
indeboliamo	tristezza
indeboliste	tristezza
indebolirebbero	tristezza
indebolendo	tristezza
indebolissero	tristezza
indebolivamo	tristezza
indebolire	tristezza
indebolivano	tristezza
indebolì	tristezza
indebolireste	tristezza
indebolisci	tristezza
indebolii	tristezza
indebolivi	tristezza
indebolissi	tristezza
indebolirò	tristezza
indebolisti	tristezza
indeboliscono	tristezza
indebolisco	tristezza
indebolivate	tristezza
indeboliremmo	tristezza
indebolenti	tristezza
indeboliranno	tristezza
indebolita	tristezza
indebolissimo	tristezza
indebolirete	tristezza
indebolisca	tristezza
indeboliti	tristezza
indebolivo	tristezza
indeboliscano	tristezza
indebolirei	tristezza
indebolimmo	tristezza
indebolisse	tristezza
indeboliremo	tristezza
indebolirebbe	tristezza
indeboliate	tristezza
indebolirai	tristezza
indebolisce	tristezza
indebolirono	tristezza
indebolir	tristezza
indeboliresti	tristezza
indeboliva	tristezza
indebolite	tristezza
indebolente	tristezza
manchi	tristezza
mancavate	tristezza
mancasti	tristezza
manchiate	tristezza
manchereste	tristezza
mancassimo	tristezza
manchino	tristezza
mancanti	tristezza
mancherete	tristezza
mancherebbe	tristezza
mancherà	tristezza
mancavamo	tristezza
mancata	tristezza
mancato	tristezza
mancare	tristezza
manca	tristezza
mancheremmo	tristezza
mancando	tristezza
mancavano	tristezza
mancassero	tristezza
mancarono	tristezza
mancava	tristezza
mancavi	tristezza
mancheranno	tristezza
mancasse	tristezza
manchiamo	tristezza
mancherebbero	tristezza
mancammo	tristezza
mancherei	tristezza
mancar	tristezza
mancante	tristezza
mancassi	tristezza
mancheresti	tristezza
mancai	tristezza
mancate	tristezza
mancaste	tristezza
mancano	tristezza
mancheremo	tristezza
manco	tristezza
mancherai	tristezza
mancherò	tristezza
mancati	tristezza
mancò	tristezza
mancavo	tristezza
lacrime	tristezza
lacrima	tristezza
scoramenti	tristezza
scoramento	tristezza
abbattuti	tristezza
abbattuta	tristezza
abbattute	tristezza
abbattuto	tristezza
sconfortataccio	tristezza
sconfortato	tristezza
sconfortatissima	tristezza
sconfortatino	tristezza
sconfortatissimo	tristezza
sconfortataccia	tristezza
sconfortatina	tristezza
sconfortatosette	tristezza
sconfortataccii	tristezza
sconfortatissime	tristezza
sconfortatosetta	tristezza
sconfortataccie	tristezza
sconfortatini	tristezza
sconfortatissimi	tristezza
sconfortata	tristezza
sconfortatosetti	tristezza
sconfortati	tristezza
sconfortatosetto	tristezza
sconfortatine	tristezza
sconfortate	tristezza
demoralizzerà	tristezza
demoralizzerai	tristezza
demoralizzi	tristezza
demoralizzassi	tristezza
demoralizzerò	tristezza
demoralizzati	tristezza
demoralizzasse	tristezza
demoralizzata	tristezza
demoralizzassero	tristezza
demoralizzanti	tristezza
demoralizzavo	tristezza
demoralizza	tristezza
demoralizzerei	tristezza
demoralizzeresti	tristezza
demoralizzare	tristezza
demoralizzavamo	tristezza
demoralizzarono	tristezza
demoralizzato	tristezza
demoralizzassimo	tristezza
demoralizzasti	tristezza
demoralizzerete	tristezza
demoralizziate	tristezza
demoralizzando	tristezza
demoralizziamo	tristezza
demoralizzano	tristezza
demoralizzar	tristezza
demoralizzavi	tristezza
demoralizzaste	tristezza
demoralizzavate	tristezza
demoralizzereste	tristezza
demoralizzerebbe	tristezza
demoralizzeranno	tristezza
demoralizzavano	tristezza
demoralizzerebbero	tristezza
demoralizzo	tristezza
demoralizzava	tristezza
demoralizzino	tristezza
demoralizzeremo	tristezza
demoralizzai	tristezza
demoralizzante	tristezza
demoralizzammo	tristezza
demoralizzeremmo	tristezza
demoralizzò	tristezza
demoralizzate	tristezza
afflitti	tristezza
afflitto	tristezza
afflitte	tristezza
afflitta	tristezza
solitari	tristezza
solitarie	tristezza
solitario	tristezza
solitaria	tristezza
scoraggiata	tristezza
scoraggiate	tristezza
scoraggiati	tristezza
scoraggiato	tristezza
penate	tristezza
penato	tristezza
penata	tristezza
penati	tristezza
depressioni	tristezza
depressione	tristezza
dolorosaccia	tristezza
dolorose	tristezza
dolorosaccii	tristezza
dolorosissimi	tristezza
dolorosine	tristezza
dolorosissime	tristezza
doloroso	tristezza
dolorosette	tristezza
dolorosissimo	tristezza
dolorosetti	tristezza
dolorosaccie	tristezza
dolorosino	tristezza
dolorosetta	tristezza
dolorosini	tristezza
dolorosaccio	tristezza
dolorosi	tristezza
dolorosetto	tristezza
dolorosina	tristezza
dolorosa	tristezza
dolorosissima	tristezza
abbattete	tristezza
abbattè	tristezza
abbattesti	tristezza
abbattono	tristezza
abbattevamo	tristezza
abbatterono	tristezza
abbattenti	tristezza
abbattesse	tristezza
abbatteremo	tristezza
abbatterai	tristezza
abbatteremmo	tristezza
abbatterebbero	tristezza
abbatteresti	tristezza
abbatterò	tristezza
abbattevi	tristezza
abbatte	tristezza
abbatteste	tristezza
abbattano	tristezza
abbattevate	tristezza
abbattessi	tristezza
abbatterà	tristezza
abbattessimo	tristezza
abbatterebbe	tristezza
abbattei	tristezza
abbattemmo	tristezza
abbattente	tristezza
abbattere	tristezza
abbatterei	tristezza
abbattiamo	tristezza
abbattuto	tristezza
abbatterete	tristezza
abbattevo	tristezza
abbattiate	tristezza
abbattuta	tristezza
abbattuti	tristezza
abbattereste	tristezza
abbatta	tristezza
abbattendo	tristezza
abbattessero	tristezza
abbatti	tristezza
abbatter	tristezza
abbatteranno	tristezza
abbattevano	tristezza
abbatteva	tristezza
abbatto	tristezza
abbattute	tristezza
demoralizzati	tristezza
demoralizzato	tristezza
demoralizzata	tristezza
demoralizzate	tristezza
cade	tristezza
cadevate	tristezza
cadente	tristezza
cadesse	tristezza
cadi	tristezza
cadiamo	tristezza
cadrete	tristezza
cadevano	tristezza
cadrei	tristezza
cadremmo	tristezza
cadiate	tristezza
cadeva	tristezza
cada	tristezza
cadreste	tristezza
caduta	tristezza
cadenti	tristezza
cadere	tristezza
cadevo	tristezza
cadevi	tristezza
caddero	tristezza
cadeste	tristezza
cadessero	tristezza
cadde	tristezza
cadevamo	tristezza
cado	tristezza
cadranno	tristezza
cadrebbero	tristezza
cadesti	tristezza
cadete	tristezza
caduto	tristezza
cadrai	tristezza
cadrò	tristezza
caddi	tristezza
cadremo	tristezza
cadute	tristezza
cademmo	tristezza
cadono	tristezza
cadrebbe	tristezza
cadessimo	tristezza
cadessi	tristezza
cadendo	tristezza
cadano	tristezza
cadresti	tristezza
cader	tristezza
caduti	tristezza
cadrà	tristezza
cupe	tristezza
cupina	tristezza
cupaccio	tristezza
cupi	tristezza
cupaccia	tristezza
cupa	tristezza
cupissima	tristezza
cuposetto	tristezza
cuposetti	tristezza
cuposetta	tristezza
cupaccie	tristezza
cupissime	tristezza
cupine	tristezza
cupino	tristezza
cuposette	tristezza
cupissimo	tristezza
cupaccii	tristezza
cupo	tristezza
cupissimi	tristezza
cupini	tristezza
scorati	tristezza
scorate	tristezza
scorata	tristezza
scorato	tristezza
taciuti	tristezza
taceste	tristezza
tacessi	tristezza
taceresti	tristezza
tacerei	tristezza
tacemmo	tristezza
taci	tristezza
tacenti	tristezza
taceremmo	tristezza
taciute	tristezza
tacerebbe	tristezza
taceremo	tristezza
tacquero	tristezza
tacete	tristezza
taciuta	tristezza
tacerà	tristezza
tacqui	tristezza
tacente	tristezza
tacere	tristezza
tacevate	tristezza
tacerai	tristezza
taciamo	tristezza
tacque	tristezza
tacciano	tristezza
tacciono	tristezza
taceranno	tristezza
tacerete	tristezza
tacerò	tristezza
tacessimo	tristezza
taciuto	tristezza
tacer	tristezza
tacesse	tristezza
tacevano	tristezza
tacevo	tristezza
taceva	tristezza
tace	tristezza
tacereste	tristezza
tacendo	tristezza
tacerebbero	tristezza
tacevamo	tristezza
taccia	tristezza
tacevi	tristezza
tacessero	tristezza
tacesti	tristezza
penar	tristezza
penavano	tristezza
penino	tristezza
pena	tristezza
penerebbero	tristezza
peniate	tristezza
peneremmo	tristezza
penate	tristezza
penerete	tristezza
penavamo	tristezza
peniamo	tristezza
penando	tristezza
penerebbe	tristezza
penano	tristezza
penanti	tristezza
penato	tristezza
penerai	tristezza
penavi	tristezza
penassimo	tristezza
penassero	tristezza
penammo	tristezza
penò	tristezza
penasti	tristezza
penare	tristezza
penai	tristezza
peneresti	tristezza
penati	tristezza
penava	tristezza
penata	tristezza
penassi	tristezza
peneremo	tristezza
penerà	tristezza
peni	tristezza
penaste	tristezza
penarono	tristezza
penavate	tristezza
penavo	tristezza
penante	tristezza
penasse	tristezza
peneranno	tristezza
penerò	tristezza
peno	tristezza
penerei	tristezza
penereste	tristezza
scorar	tristezza
scorino	tristezza
scorante	tristezza
scorato	tristezza
scorasse	tristezza
scorerete	tristezza
scorati	tristezza
scorassi	tristezza
scoraste	tristezza
scoranti	tristezza
scorerà	tristezza
scorassero	tristezza
scoravamo	tristezza
scorò	tristezza
scora	tristezza
scorerai	tristezza
scorerebbe	tristezza
scoreresti	tristezza
scorerebbero	tristezza
scoriamo	tristezza
scorerò	tristezza
scoriate	tristezza
scoravi	tristezza
scorerei	tristezza
scoravate	tristezza
scorarono	tristezza
scorereste	tristezza
scoreranno	tristezza
scoravo	tristezza
scorava	tristezza
scorando	tristezza
scoreremo	tristezza
scorata	tristezza
scoreremmo	tristezza
scori	tristezza
scorai	tristezza
scorassimo	tristezza
scoro	tristezza
scorammo	tristezza
scoravano	tristezza
scorasti	tristezza
scorate	tristezza
scorare	tristezza
scorano	tristezza
tristezza	tristezza
tristezze	tristezza
silenziosissime	tristezza
silenziosetta	tristezza
silenziose	tristezza
silenziosina	tristezza
silenziosino	tristezza
silenziosetto	tristezza
silenziosissimi	tristezza
silenziosette	tristezza
silenziosaccii	tristezza
silenziosaccie	tristezza
silenziosa	tristezza
silenziosissima	tristezza
silenziosaccio	tristezza
silenziosine	tristezza
silenzioso	tristezza
silenziosi	tristezza
silenziosetti	tristezza
silenziosini	tristezza
silenziosaccia	tristezza
silenziosissimo	tristezza
neri	tristezza
nero	tristezza
nascondesse	tristezza
nasconde	tristezza
nascondessi	tristezza
nascondessimo	tristezza
nasconderei	tristezza
nascondeva	tristezza
nascondessero	tristezza
nascondente	tristezza
nasconderanno	tristezza
nascondevate	tristezza
nasconderebbe	tristezza
nascondano	tristezza
nascondiamo	tristezza
nascondevi	tristezza
nascosti	tristezza
nascoste	tristezza
nascondemmo	tristezza
nasconderà	tristezza
nascosto	tristezza
nascondevano	tristezza
nasconderemmo	tristezza
nascondeste	tristezza
nascosi	tristezza
nasconda	tristezza
nascondevo	tristezza
nascondiate	tristezza
nascondendo	tristezza
nasconderete	tristezza
nascondo	tristezza
nasconder	tristezza
nasconderò	tristezza
nasconderemo	tristezza
nascosero	tristezza
nascondenti	tristezza
nascondevamo	tristezza
nascondere	tristezza
nascose	tristezza
nascondono	tristezza
nascosta	tristezza
nascondesti	tristezza
nascondereste	tristezza
nasconderai	tristezza
nasconderesti	tristezza
nasconderebbero	tristezza
nascondi	tristezza
nascondete	tristezza
cupezza	tristezza
cupezze	tristezza
riflettendo	tristezza
rifletterò	tristezza
rifletti	tristezza
riflettiate	tristezza
riflettuta	tristezza
rifletto	tristezza
riflettè	tristezza
rifletta	tristezza
rifletterete	tristezza
rifletterebbe	tristezza
rifletterei	tristezza
riflettereste	tristezza
riflettere	tristezza
riflettesse	tristezza
riflettessero	tristezza
riflettuto	tristezza
riflettevi	tristezza
riflettiamo	tristezza
rifletterai	tristezza
rifletteva	tristezza
rifletterebbero	tristezza
riflettemmo	tristezza
rifletteresti	tristezza
rifletterà	tristezza
rifletterono	tristezza
rifletteremmo	tristezza
riflettente	tristezza
riflettuti	tristezza
riflettessi	tristezza
riflettono	tristezza
riflettessimo	tristezza
riflettevamo	tristezza
riflettete	tristezza
riflette	tristezza
rifletter	tristezza
riflettevate	tristezza
riflettevo	tristezza
riflettevano	tristezza
riflettei	tristezza
riflettenti	tristezza
riflettute	tristezza
rifletteranno	tristezza
rifletteremo	tristezza
rifletteste	tristezza
riflettesti	tristezza
riflettano	tristezza
deprimentissimi	tristezza
deprimentissimo	tristezza
deprimentissima	tristezza
deprimenti	tristezza
deprimente	tristezza
deprimentissime	tristezza
infelicità	tristezza
accasciato	tristezza
accasciata	tristezza
accasciate	tristezza
accasciati	tristezza
avviliti	tristezza
avvilite	tristezza
avvilito	tristezza
avvilita	tristezza
nostalgico	tristezza
nostalgica	tristezza
nostalgiche	tristezza
nostalgici	tristezza
mestina	tristezza
mestosetta	tristezza
mestissimo	tristezza
mestissime	tristezza
mestosetto	tristezza
mestaccii	tristezza
mestissimi	tristezza
mesto	tristezza
mestissima	tristezza
mestino	tristezza
mestaccia	tristezza
mestini	tristezza
mestaccie	tristezza
mestosetti	tristezza
mesti	tristezza
mestine	tristezza
mesta	tristezza
mestaccio	tristezza
mestosette	tristezza
meste	tristezza
scoraggiamento	tristezza
scoraggiamenti	tristezza
amarezze	tristezza
amarezza	tristezza
scoraggerebbe	tristezza
scoraggerei	tristezza
scoraggerà	tristezza
scoraggianti	tristezza
scoraggiaste	tristezza
scoraggeremmo	tristezza
scoraggiar	tristezza
scoraggiavamo	tristezza
scoraggiato	tristezza
scoraggiavi	tristezza
scoraggiarono	tristezza
scoraggi	tristezza
scoraggiai	tristezza
scoraggiavate	tristezza
scoraggino	tristezza
scoraggiammo	tristezza
scoraggiante	tristezza
scoraggio	tristezza
scoraggeranno	tristezza
scoraggeremo	tristezza
scoraggiava	tristezza
scoraggiamo	tristezza
scoraggiassi	tristezza
scoraggiassimo	tristezza
scoraggiati	tristezza
scoraggerò	tristezza
scoraggiassero	tristezza
scoraggiare	tristezza
scoraggiasse	tristezza
scoraggiavo	tristezza
scoraggeresti	tristezza
scoraggiavano	tristezza
scoraggia	tristezza
scoraggereste	tristezza
scoraggerebbero	tristezza
scoraggerai	tristezza
scoraggiando	tristezza
scoraggiate	tristezza
scoraggiano	tristezza
scoraggerete	tristezza
scoraggiasti	tristezza
scoraggiò	tristezza
scoraggiata	tristezza
grigie	tristezza
grigio	tristezza
grigi	tristezza
grigia	tristezza
mogissima	tristezza
moge	tristezza
mogissime	tristezza
mogio	tristezza
mogissimi	tristezza
mogi	tristezza
mogissimo	tristezza
mogia	tristezza
lugubri	tristezza
lugubre	tristezza
sincerissima	fiducia
sincerissime	fiducia
sincera	fiducia
sincerini	fiducia
sincerissimi	fiducia
sinceraccii	fiducia
sincerosetto	fiducia
sinceraccia	fiducia
sincere	fiducia
sinceri	fiducia
sincerine	fiducia
sincerosetti	fiducia
sinceraccie	fiducia
sincerino	fiducia
sincero	fiducia
sinceraccio	fiducia
sincerosette	fiducia
sincerissimo	fiducia
sincerosetta	fiducia
sincerina	fiducia
responsabili	fiducia
responsabile	fiducia
accertato	fiducia
accertata	fiducia
accertati	fiducia
accertate	fiducia
tranquillosetto	fiducia
tranquillaccii	fiducia
tranquillaccia	fiducia
tranquillissime	fiducia
tranquillosette	fiducia
tranquillosetta	fiducia
tranquillo	fiducia
tranquillosetti	fiducia
tranquillissima	fiducia
tranquillini	fiducia
tranquillaccie	fiducia
tranquillaccio	fiducia
tranquillissimi	fiducia
tranquillina	fiducia
tranquilline	fiducia
tranquilla	fiducia
tranquilli	fiducia
tranquillissimo	fiducia
tranquille	fiducia
tranquillino	fiducia
raccontanti	fiducia
racconterete	fiducia
raccontammo	fiducia
raccontino	fiducia
raccontato	fiducia
racconterei	fiducia
raccontano	fiducia
racconterebbe	fiducia
raccontiate	fiducia
raccontassero	fiducia
raccontavamo	fiducia
raccontavate	fiducia
raccontate	fiducia
racconterò	fiducia
racconti	fiducia
raccontiamo	fiducia
raccontavo	fiducia
raccontati	fiducia
racconterai	fiducia
racconterà	fiducia
raccontarono	fiducia
raccontassi	fiducia
raccontassimo	fiducia
raccontante	fiducia
raccontaste	fiducia
racconterebbero	fiducia
racconto	fiducia
raccontavano	fiducia
raccontare	fiducia
racconteremmo	fiducia
raccontereste	fiducia
raccontai	fiducia
raccontò	fiducia
racconteremo	fiducia
raccontata	fiducia
raccontasse	fiducia
raccontasti	fiducia
raccontava	fiducia
racconteranno	fiducia
racconta	fiducia
racconteresti	fiducia
raccontavi	fiducia
raccontar	fiducia
raccontando	fiducia
lavoro	fiducia
accertavamo	fiducia
accertasti	fiducia
accertassi	fiducia
accerteresti	fiducia
accertassero	fiducia
accertavano	fiducia
accerta	fiducia
accertereste	fiducia
accertare	fiducia
accertate	fiducia
accerterai	fiducia
accertati	fiducia
accertammo	fiducia
accertai	fiducia
accertiate	fiducia
accerterà	fiducia
accertanti	fiducia
accerto	fiducia
accertassimo	fiducia
accertar	fiducia
accerti	fiducia
accertaste	fiducia
accertavi	fiducia
accertarono	fiducia
accertino	fiducia
accertavate	fiducia
accertiamo	fiducia
accertavo	fiducia
accerteranno	fiducia
accerteremmo	fiducia
accertata	fiducia
accertando	fiducia
accerterò	fiducia
accertano	fiducia
accertasse	fiducia
accertava	fiducia
accerterebbero	fiducia
accerterete	fiducia
accertò	fiducia
accertato	fiducia
accerteremo	fiducia
accerterebbe	fiducia
accertante	fiducia
accerterei	fiducia
convincimento	fiducia
convincimenti	fiducia
trasparenti	fiducia
trasparente	fiducia
trasparentissima	fiducia
trasparentissime	fiducia
trasparentissimo	fiducia
trasparentissimi	fiducia
confidenza	fiducia
confidenze	fiducia
credente	fiducia
credenti	fiducia
danno	fiducia
danti	fiducia
dante	fiducia
da'	fiducia
dar	fiducia
dessi	fiducia
daremmo	fiducia
dati	fiducia
dando	fiducia
dareste	fiducia
diate	fiducia
desse	fiducia
darebbero	fiducia
darò	fiducia
darebbe	fiducia
darei	fiducia
diano	fiducia
darete	fiducia
do	fiducia
davate	fiducia
demmo	fiducia
diedero	fiducia
darà	fiducia
deste	fiducia
dai	fiducia
davo	fiducia
dessero	fiducia
diedi	fiducia
dia	fiducia
date	fiducia
diamo	fiducia
daranno	fiducia
dato	fiducia
desti	fiducia
dava	fiducia
data	fiducia
dà	fiducia
davano	fiducia
daremo	fiducia
diede	fiducia
dare	fiducia
dessimo	fiducia
davi	fiducia
davamo	fiducia
daresti	fiducia
darai	fiducia
dipendenza	fiducia
dipendenze	fiducia
amichevolissima	fiducia
amichevole	fiducia
amichevolissime	fiducia
amichevoli	fiducia
amichevolissimi	fiducia
amichevolissimo	fiducia
sincerità	fiducia
sicurezza	fiducia
sicurezze	fiducia
assicurazione	fiducia
assicurazioni	fiducia
speranze	fiducia
speranza	fiducia
assegnamento	fiducia
assegnamenti	fiducia
responsabilizzavamo	fiducia
responsabilizzasse	fiducia
responsabilizzate	fiducia
responsabilizzava	fiducia
responsabilizzeranno	fiducia
responsabilizzaste	fiducia
responsabilizzavi	fiducia
responsabilizzerà	fiducia
responsabilizzerò	fiducia
responsabilizzino	fiducia
responsabilizzano	fiducia
responsabilizzassero	fiducia
responsabilizzar	fiducia
responsabilizzavo	fiducia
responsabilizzata	fiducia
responsabilizzerebbero	fiducia
responsabilizza	fiducia
responsabilizzò	fiducia
responsabilizzati	fiducia
responsabilizzerai	fiducia
responsabilizzereste	fiducia
responsabilizzasti	fiducia
responsabilizzerebbe	fiducia
responsabilizzassi	fiducia
responsabilizzante	fiducia
responsabilizzassimo	fiducia
responsabilizziate	fiducia
responsabilizzammo	fiducia
responsabilizzeremmo	fiducia
responsabilizzi	fiducia
responsabilizzeremo	fiducia
responsabilizzare	fiducia
responsabilizzai	fiducia
responsabilizzanti	fiducia
responsabilizzato	fiducia
responsabilizzeresti	fiducia
responsabilizzerei	fiducia
responsabilizzo	fiducia
responsabilizzando	fiducia
responsabilizzarono	fiducia
responsabilizzavano	fiducia
responsabilizzerete	fiducia
responsabilizziamo	fiducia
responsabilizzavate	fiducia
ottimismo	fiducia
ottimismi	fiducia
affidabilissimi	fiducia
affidabilissime	fiducia
affidabili	fiducia
affidabile	fiducia
affidabilissima	fiducia
affidabilissimo	fiducia
legavate	fiducia
legammo	fiducia
legherete	fiducia
legaste	fiducia
legano	fiducia
legante	fiducia
legherò	fiducia
legherai	fiducia
leganti	fiducia
lega	fiducia
legassi	fiducia
legò	fiducia
legasti	fiducia
legherà	fiducia
leghiate	fiducia
legavano	fiducia
legando	fiducia
legavo	fiducia
lego	fiducia
legati	fiducia
legherei	fiducia
legheresti	fiducia
legava	fiducia
legare	fiducia
legato	fiducia
legar	fiducia
legate	fiducia
legheranno	fiducia
legata	fiducia
legherebbero	fiducia
legavamo	fiducia
legheremo	fiducia
leghereste	fiducia
legheremmo	fiducia
legavi	fiducia
leghi	fiducia
leghiamo	fiducia
leghino	fiducia
legai	fiducia
legasse	fiducia
legherebbe	fiducia
legassimo	fiducia
legarono	fiducia
legassero	fiducia
certosetti	fiducia
certosette	fiducia
certa	fiducia
certe	fiducia
certaccii	fiducia
certissimo	fiducia
certosetta	fiducia
certissimi	fiducia
certissime	fiducia
certini	fiducia
certaccio	fiducia
certine	fiducia
certissima	fiducia
certi	fiducia
certosetto	fiducia
certino	fiducia
certina	fiducia
certaccie	fiducia
certo	fiducia
certaccia	fiducia
innocentissimo	fiducia
innocenti	fiducia
innocente	fiducia
innocentissima	fiducia
innocentissime	fiducia
innocentissimi	fiducia
affiderei	fiducia
affidiamo	fiducia
affidereste	fiducia
affidassi	fiducia
affidasti	fiducia
affidando	fiducia
affida	fiducia
affidassimo	fiducia
affidò	fiducia
affidano	fiducia
affidasse	fiducia
affidava	fiducia
affidante	fiducia
affidiate	fiducia
affidavate	fiducia
affideremo	fiducia
affidavi	fiducia
affiderai	fiducia
affidavamo	fiducia
affidavano	fiducia
affidarono	fiducia
affideranno	fiducia
affiderò	fiducia
affiderebbe	fiducia
affiderebbero	fiducia
affido	fiducia
affidate	fiducia
affiderete	fiducia
affidare	fiducia
affidati	fiducia
affidato	fiducia
affiderà	fiducia
affidi	fiducia
affidata	fiducia
affideremmo	fiducia
affidammo	fiducia
affidar	fiducia
affidassero	fiducia
affidino	fiducia
affidai	fiducia
affidanti	fiducia
affidaste	fiducia
affideresti	fiducia
affidavo	fiducia
lealtà	fiducia
candidaccie	fiducia
candidissime	fiducia
candidissima	fiducia
candidissimo	fiducia
candidosetta	fiducia
candidaccio	fiducia
candidosetti	fiducia
candidissimi	fiducia
candidosette	fiducia
candidaccii	fiducia
candida	fiducia
candidina	fiducia
candidine	fiducia
candide	fiducia
candidino	fiducia
candidini	fiducia
candido	fiducia
candidi	fiducia
candidosetto	fiducia
candidaccia	fiducia
riservare	fiducia
riserva	fiducia
riservando	fiducia
riserverei	fiducia
riservò	fiducia
riserveremo	fiducia
riserverebbe	fiducia
riservato	fiducia
riserverete	fiducia
riservaste	fiducia
riservino	fiducia
riservanti	fiducia
riserveresti	fiducia
riservassimo	fiducia
riservassi	fiducia
riservereste	fiducia
riservati	fiducia
riserviamo	fiducia
riserviate	fiducia
riservasti	fiducia
riservano	fiducia
riserverebbero	fiducia
riservava	fiducia
riservar	fiducia
riserverò	fiducia
riservavi	fiducia
riserveranno	fiducia
riservata	fiducia
riservi	fiducia
riservarono	fiducia
riservavamo	fiducia
riservavo	fiducia
riservante	fiducia
riserverà	fiducia
riservate	fiducia
riservavano	fiducia
riservasse	fiducia
riservo	fiducia
riserveremmo	fiducia
riservammo	fiducia
riservavate	fiducia
riservai	fiducia
riservassero	fiducia
riserverai	fiducia
aspettativa	fiducia
aspettative	fiducia
guardereste	fiducia
guardavate	fiducia
guarderete	fiducia
guardo	fiducia
guarderò	fiducia
guarderemmo	fiducia
guardammo	fiducia
guardar	fiducia
guardati	fiducia
guardate	fiducia
guardasse	fiducia
guardò	fiducia
guardavo	fiducia
guardante	fiducia
guardando	fiducia
guardai	fiducia
guardavano	fiducia
guardassi	fiducia
guarderanno	fiducia
guardarono	fiducia
guarderai	fiducia
guardino	fiducia
guardato	fiducia
guardaste	fiducia
guardiamo	fiducia
guarderebbero	fiducia
guardano	fiducia
guardanti	fiducia
guardassero	fiducia
guardasti	fiducia
guardi	fiducia
guarda	fiducia
guarderà	fiducia
guardare	fiducia
guarderesti	fiducia
guardiate	fiducia
guardassimo	fiducia
guardavamo	fiducia
guarderei	fiducia
guarderemo	fiducia
guardata	fiducia
guarderebbe	fiducia
guardava	fiducia
guardavi	fiducia
sicurissimo	fiducia
sicurina	fiducia
sicurino	fiducia
sicuri	fiducia
sicurosetta	fiducia
sicurissimi	fiducia
sicurosetti	fiducia
sicura	fiducia
sicurine	fiducia
sicuraccie	fiducia
sicuraccii	fiducia
sicuraccia	fiducia
sicurissima	fiducia
sicuro	fiducia
sicurini	fiducia
sicure	fiducia
sicuraccio	fiducia
sicurosette	fiducia
sicurosetto	fiducia
sicurissime	fiducia
famiglia	fiducia
famiglie	fiducia
ingenui	fiducia
ingenua	fiducia
ingenue	fiducia
ingenuo	fiducia
fidata	fiducia
fidate	fiducia
fidato	fiducia
fidati	fiducia
unione	fiducia
unioni	fiducia
lealissimi	fiducia
lealissimo	fiducia
leali	fiducia
lealissime	fiducia
leale	fiducia
lealissima	fiducia
fiducie	fiducia
fiducia	fiducia
riservata	fiducia
riservati	fiducia
riservate	fiducia
riservato	fiducia
fedelissima	fiducia
fedelissimi	fiducia
fedelissime	fiducia
fedelissimo	fiducia
fedele	fiducia
fedeli	fiducia
realtà	fiducia
certezza	fiducia
certezze	fiducia
garantii	fiducia
garantissero	fiducia
garantiscono	fiducia
garantisti	fiducia
garantirebbe	fiducia
garantiranno	fiducia
garantiresti	fiducia
garantivate	fiducia
garantimmo	fiducia
garantiremmo	fiducia
garantissi	fiducia
garantirai	fiducia
garantiti	fiducia
garantiate	fiducia
garantirebbero	fiducia
garantente	fiducia
garantite	fiducia
garantendo	fiducia
garantirono	fiducia
garantivano	fiducia
garantivo	fiducia
garantito	fiducia
garantì	fiducia
garantiamo	fiducia
garantiremo	fiducia
garantiva	fiducia
garantivamo	fiducia
garantir	fiducia
garantirei	fiducia
garantiste	fiducia
garantita	fiducia
garantenti	fiducia
garantisce	fiducia
garantisca	fiducia
garantirò	fiducia
garantisse	fiducia
garantirà	fiducia
garantivi	fiducia
garantisci	fiducia
garantire	fiducia
garantissimo	fiducia
garantiscano	fiducia
garantireste	fiducia
garantisco	fiducia
garantirete	fiducia
crediate	fiducia
credeva	fiducia
crederanno	fiducia
credevano	fiducia
credano	fiducia
credereste	fiducia
credettero	fiducia
credono	fiducia
creduta	fiducia
credesse	fiducia
creduti	fiducia
credevo	fiducia
credetti	fiducia
crederai	fiducia
credendo	fiducia
crederà	fiducia
credessero	fiducia
credesti	fiducia
credevamo	fiducia
credo	fiducia
creduto	fiducia
credente	fiducia
credessi	fiducia
credessimo	fiducia
crederete	fiducia
crederò	fiducia
credute	fiducia
credenti	fiducia
creder	fiducia
crederebbe	fiducia
credevi	fiducia
creda	fiducia
crederei	fiducia
credemmo	fiducia
credevate	fiducia
crederesti	fiducia
crederebbero	fiducia
credeste	fiducia
crederemmo	fiducia
crederemo	fiducia
credere	fiducia
credi	fiducia
credete	fiducia
crediamo	fiducia
credette	fiducia
crede	fiducia
legami	fiducia
legame	fiducia
gratosette	fiducia
grataccii	fiducia
grate	fiducia
gratina	fiducia
gratini	fiducia
grati	fiducia
gratissimi	fiducia
grato	fiducia
grataccia	fiducia
gratissimo	fiducia
gratino	fiducia
grataccio	fiducia
grataccie	fiducia
gratosetto	fiducia
gratosetti	fiducia
grata	fiducia
gratine	fiducia
gratissima	fiducia
gratosetta	fiducia
gratissime	fiducia
onestosette	fiducia
onestaccia	fiducia
onestissimi	fiducia
onestissima	fiducia
onestina	fiducia
onesta	fiducia
onesto	fiducia
onestosetto	fiducia
oneste	fiducia
onestosetta	fiducia
onestaccio	fiducia
onestaccie	fiducia
onestaccii	fiducia
onestissime	fiducia
onestosetti	fiducia
onestino	fiducia
onestine	fiducia
onesti	fiducia
onestissimo	fiducia
onestini	fiducia
convinto	fiducia
convinta	fiducia
convinte	fiducia
convinti	fiducia
corretta	fiducia
corrette	fiducia
corretto	fiducia
corretti	fiducia
stringerebbero	fiducia
stringiamo	fiducia
stringer	fiducia
strette	fiducia
stringano	fiducia
stringente	fiducia
stringeranno	fiducia
stringeste	fiducia
stringevo	fiducia
stringesti	fiducia
stringesse	fiducia
stretta	fiducia
stringa	fiducia
stringerà	fiducia
stringi	fiducia
strinsero	fiducia
stringessi	fiducia
stringeremmo	fiducia
stringevano	fiducia
strinsi	fiducia
stringendo	fiducia
stringessimo	fiducia
stretto	fiducia
stringeva	fiducia
stringerete	fiducia
stringerei	fiducia
stringevamo	fiducia
stringevate	fiducia
stringete	fiducia
strinse	fiducia
stringemmo	fiducia
stringereste	fiducia
stringevi	fiducia
stringerai	fiducia
stringenti	fiducia
stringessero	fiducia
stringono	fiducia
stringiate	fiducia
stringe	fiducia
stretti	fiducia
stringeresti	fiducia
stringerò	fiducia
stringeremo	fiducia
stringerebbe	fiducia
stringere	fiducia
ricever	fiducia
riceveresti	fiducia
ricevevano	fiducia
riceve	fiducia
riceverà	fiducia
riceveremo	fiducia
ricevereste	fiducia
ricevuta	fiducia
ricevessimo	fiducia
riceveremmo	fiducia
riceventi	fiducia
ricevemmo	fiducia
ricevesse	fiducia
ricevono	fiducia
riceveste	fiducia
riceverei	fiducia
riceverebbero	fiducia
ricevevamo	fiducia
ricevendo	fiducia
riceveranno	fiducia
ricevetti	fiducia
ricevettero	fiducia
ricevuti	fiducia
ricevessero	fiducia
riceviamo	fiducia
riceveva	fiducia
riceverai	fiducia
ricevano	fiducia
riceverò	fiducia
ricevi	fiducia
ricevuto	fiducia
riceva	fiducia
ricevevate	fiducia
ricevevo	fiducia
ricevere	fiducia
ricevevi	fiducia
ricevette	fiducia
riceverebbe	fiducia
ricevute	fiducia
ricevente	fiducia
riceverete	fiducia
ricevessi	fiducia
riceviate	fiducia
ricevo	fiducia
ricevete	fiducia
ricevesti	fiducia
fidasti	fiducia
fidato	fiducia
fidò	fiducia
fidando	fiducia
fidammo	fiducia
fidate	fiducia
fidata	fiducia
fidino	fiducia
fiderai	fiducia
fideranno	fiducia
fideremmo	fiducia
fido	fiducia
fidai	fiducia
fidar	fiducia
fidassero	fiducia
fidassi	fiducia
fiderebbero	fiducia
fidiate	fiducia
fidanti	fiducia
fiderò	fiducia
fidavamo	fiducia
fida	fiducia
fidare	fiducia
fideresti	fiducia
fidava	fiducia
fidiamo	fiducia
fidi	fiducia
fiderete	fiducia
fidarono	fiducia
fidati	fiducia
fidassimo	fiducia
fidante	fiducia
fidaste	fiducia
fidavano	fiducia
fidano	fiducia
fiderei	fiducia
fidereste	fiducia
fidavo	fiducia
fidavate	fiducia
fidasse	fiducia
fiderà	fiducia
fiderebbe	fiducia
fidavi	fiducia
fideremo	fiducia
confidenti	fiducia
confidente	fiducia
convinzioni	fiducia
convinzione	fiducia
familiarissima	fiducia
familiarissimo	fiducia
familiarissime	fiducia
familiarissimi	fiducia
familiare	fiducia
familiari	fiducia
verità	fiducia
garanzie	fiducia
garanzia	fiducia
profezia	attese
profezie	attese
desiderio	attese
desideri	attese
agitazione	attese
agitazioni	attese
attendesti	attese
attendere	attese
attendevano	attese
attendono	attese
atteso	attese
attendevate	attese
attendevamo	attese
attesa	attese
attenda	attese
attendendo	attese
attendenti	attese
attendeste	attese
attendete	attese
attendente	attese
attendemmo	attese
attendesse	attese
attendessero	attese
attendi	attese
attende	attese
attendano	attese
attendeva	attese
attendessimo	attese
attendessi	attese
attesero	attese
attese	attese
attesi	attese
attendevi	attese
attender	attese
attendevo	attese
treno	attese
treni	attese
immaginare	attese
immaginavi	attese
immagineresti	attese
immaginava	attese
immaginante	attese
immaginai	attese
immaginò	attese
immagineremo	attese
immaginasse	attese
immaginassero	attese
immaginanti	attese
immaginerete	attese
immaginar	attese
immaginati	attese
immaginino	attese
immaginato	attese
immaginerai	attese
immaginassi	attese
immaginata	attese
immaginavamo	attese
immaginerò	attese
immaginerebbe	attese
immaginavano	attese
immagini	attese
immaginerà	attese
immagineremmo	attese
immaginereste	attese
immaginaste	attese
immaginano	attese
immagineranno	attese
immaginiate	attese
immaginavate	attese
immaginando	attese
immaginate	attese
immaginammo	attese
immaginasti	attese
immaginavo	attese
immaginassimo	attese
immagina	attese
immaginerebbero	attese
immaginerei	attese
immagino	attese
immaginiamo	attese
immaginarono	attese
prefigurazione	attese
prefigurazioni	attese
prevediamo	attese
preveder	attese
previste	attese
prevedrai	attese
prevista	attese
prevedendo	attese
prevede	attese
prevedesti	attese
preveda	attese
prevedresti	attese
prevedevano	attese
prevedente	attese
prevedeva	attese
prevedrebbero	attese
prevedremmo	attese
prevedi	attese
previdero	attese
prevedevamo	attese
previde	attese
prevedenti	attese
prevedo	attese
prevedessimo	attese
prevedremo	attese
previsti	attese
prevedrei	attese
prevedere	attese
prevedreste	attese
prevedrò	attese
prevedeste	attese
previdi	attese
prevediate	attese
prevedevo	attese
prevedevate	attese
prevedessero	attese
previsto	attese
prevedemmo	attese
prevedessi	attese
prevedranno	attese
prevedrebbe	attese
prevedete	attese
prevedano	attese
prevedrete	attese
prevedesse	attese
prevedevi	attese
prevedrà	attese
prevedono	attese
predizione	attese
predizioni	attese
auspicati	attese
auspicato	attese
auspicata	attese
auspicate	attese
congettura	attese
congetture	attese
pazientassimo	attese
paziento	attese
pazienterai	attese
pazientaste	attese
pazientiate	attese
pazienterò	attese
pazientereste	attese
pazientavi	attese
pazienterei	attese
pazientavate	attese
pazientando	attese
pazienterete	attese
pazientasse	attese
pazientavamo	attese
pazientano	attese
pazientavo	attese
pazientai	attese
pazientavano	attese
pazientasti	attese
pazientata	attese
pazientati	attese
pazienterebbe	attese
pazientare	attese
pazienteremo	attese
pazienti	attese
pazienterebbero	attese
pazientammo	attese
pazientanti	attese
pazienta	attese
pazientassero	attese
pazientato	attese
pazientassi	attese
pazientava	attese
pazientino	attese
pazientò	attese
pazientar	attese
pazienterà	attese
pazientarono	attese
pazienteresti	attese
pazientate	attese
pazientiamo	attese
pazientante	attese
pazienteremmo	attese
pazienteranno	attese
presagio	attese
presagi	attese
prediremmo	attese
prediciamo	attese
predirai	attese
predetti	attese
prediceste	attese
prediceva	attese
predire	attese
predicevamo	attese
predirei	attese
predissi	attese
predette	attese
predicesti	attese
predici	attese
predicente	attese
predice	attese
predì	attese
predirebbero	attese
predicessimo	attese
predirete	attese
predirebbe	attese
prediremo	attese
predicevo	attese
predicevano	attese
predicevi	attese
predicono	attese
prediresti	attese
predisse	attese
predicendo	attese
predicenti	attese
predirà	attese
predicesse	attese
predirò	attese
prediciate	attese
predir	attese
predicevate	attese
predicemmo	attese
prediranno	attese
predissero	attese
predetto	attese
predetta	attese
predireste	attese
predite	attese
predicano	attese
predica	attese
predicessi	attese
proiezioni	attese
proiezione	attese
trepidanti	attese
trepidantissime	attese
trepidantissimi	attese
trepidante	attese
trepidantissima	attese
trepidantissimo	attese
predette	attese
predetto	attese
predetti	attese
predetta	attese
bramati	attese
bramato	attese
bramata	attese
bramate	attese
fremerebbero	attese
fremerono	attese
fremevano	attese
fremei	attese
fremete	attese
fremiamo	attese
fremessi	attese
freme	attese
fremè	attese
frementi	attese
fremi	attese
fremerete	attese
frema	attese
fremendo	attese
fremeremmo	attese
fremute	attese
fremesse	attese
fremuta	attese
fremuto	attese
fremessero	attese
fremeremo	attese
fremerei	attese
fremevi	attese
fremuti	attese
fremiate	attese
fremerò	attese
fremeva	attese
fremesti	attese
fremevamo	attese
fremeresti	attese
frememmo	attese
fremessimo	attese
fremevate	attese
fremeranno	attese
fremerai	attese
fremerebbe	attese
fremente	attese
fremono	attese
fremereste	attese
fremeste	attese
fremevo	attese
fremerà	attese
fremer	attese
fremere	attese
fremano	attese
fremo	attese
voluti	attese
voluto	attese
volute	attese
voluta	attese
pronosticherà	attese
pronosticassimo	attese
pronosticavi	attese
pronosticheremmo	attese
pronosticarono	attese
pronosticavo	attese
pronostichino	attese
pronosticante	attese
pronosticai	attese
pronostichiamo	attese
pronosticasti	attese
pronosticar	attese
pronosticassero	attese
pronosticate	attese
pronosticammo	attese
pronosticasse	attese
pronosticata	attese
pronosticherebbe	attese
pronostichereste	attese
pronosticano	attese
pronosticavano	attese
pronostica	attese
pronosticare	attese
pronostico	attese
pronosticati	attese
pronosticherebbero	attese
pronosticaste	attese
pronostichiate	attese
pronosticava	attese
pronosticherò	attese
pronosticò	attese
pronosticato	attese
pronostichi	attese
pronosticherei	attese
pronosticheremo	attese
pronosticheresti	attese
pronosticavate	attese
pronosticando	attese
pronosticheranno	attese
pronosticherete	attese
pronosticassi	attese
pronosticanti	attese
pronosticherai	attese
pronosticavamo	attese
agogneranno	attese
agognerà	attese
agognano	attese
agognante	attese
agognavate	attese
agogneremo	attese
agogni	attese
agognavo	attese
agognate	attese
agognarono	attese
agognando	attese
agognasse	attese
agognassimo	attese
agognaste	attese
agognati	attese
agognavano	attese
agognavi	attese
agogniamo	attese
agognerebbero	attese
agognai	attese
agognare	attese
agognerai	attese
agognata	attese
agognassero	attese
agognerebbe	attese
agognò	attese
agogno	attese
agognasti	attese
agogniate	attese
agognereste	attese
agognassi	attese
agognava	attese
agognavamo	attese
agognino	attese
agognanti	attese
agognato	attese
agognerete	attese
agogneresti	attese
agognerei	attese
agognammo	attese
agognar	attese
agognerò	attese
agogneremmo	attese
agogna	attese
supposte	attese
supposta	attese
supposti	attese
supposto	attese
sperata	attese
sperato	attese
sperate	attese
sperati	attese
sospirò	attese
sospiro	attese
sospirassi	attese
sospirerete	attese
sospirano	attese
sospirata	attese
sospirar	attese
sospiraste	attese
sospiravano	attese
sospirati	attese
sospirando	attese
sospirare	attese
sospirassimo	attese
sospirerebbe	attese
sospirate	attese
sospiravi	attese
sospira	attese
sospirasti	attese
sospiranti	attese
sospirassero	attese
sospireremo	attese
sospireremmo	attese
sospiriate	attese
sospireranno	attese
sospirerebbero	attese
sospirerei	attese
sospirai	attese
sospiravo	attese
sospirerò	attese
sospirerai	attese
sospirante	attese
sospiravate	attese
sospirereste	attese
sospiravamo	attese
sospiri	attese
sospirerà	attese
sospirarono	attese
sospirammo	attese
sospirava	attese
sospireresti	attese
sospiriamo	attese
sospirino	attese
sospirato	attese
sospirasse	attese
aspettate	attese
aspettata	attese
aspettato	attese
aspettati	attese
risultati	attese
risultato	attese
attese	attese
attesi	attese
atteso	attese
attesa	attese
aspettando	attese
aspetti	attese
aspetterà	attese
aspettai	attese
aspettante	attese
aspettata	attese
aspettavo	attese
aspetterò	attese
aspettassimo	attese
aspettassi	attese
aspettaste	attese
aspetteranno	attese
aspetterebbero	attese
aspettereste	attese
aspetteresti	attese
aspettassero	attese
aspettiamo	attese
aspettavano	attese
aspetterebbe	attese
aspettato	attese
aspettasse	attese
aspettate	attese
aspettavate	attese
aspetta	attese
aspettati	attese
aspettare	attese
aspettò	attese
aspetterete	attese
aspettavi	attese
aspetto	attese
aspettar	attese
aspettiate	attese
aspettammo	attese
aspettanti	attese
aspetterai	attese
aspettasti	attese
aspetteremmo	attese
aspettino	attese
aspettavamo	attese
aspettarono	attese
aspetteremo	attese
aspetterei	attese
aspettano	attese
aspettava	attese
invocassi	attese
invocheremmo	attese
invoca	attese
invocavate	attese
invocherà	attese
invocavo	attese
invocheresti	attese
invochino	attese
invocando	attese
invocherei	attese
invocherai	attese
invocata	attese
invocar	attese
invocato	attese
invocaste	attese
invocassero	attese
invochereste	attese
invocheranno	attese
invocava	attese
invocasse	attese
invocò	attese
invocai	attese
invochiate	attese
invocano	attese
invocate	attese
invochiamo	attese
invoco	attese
invocherebbero	attese
invocarono	attese
invocante	attese
invocherebbe	attese
invocherete	attese
invocherò	attese
invocati	attese
invocasti	attese
invocanti	attese
invocheremo	attese
invocammo	attese
invocare	attese
invocavano	attese
invocassimo	attese
invochi	attese
invocavi	attese
invocavamo	attese
aspettativa	attese
aspettative	attese
previsioni	attese
previsione	attese
auspicasti	attese
auspicaste	attese
auspicassi	attese
auspicheremo	attese
auspicati	attese
auspicherebbero	attese
auspicava	attese
auspichi	attese
auspicato	attese
auspicavamo	attese
auspicavo	attese
auspicano	attese
auspicherebbe	attese
auspicò	attese
auspicar	attese
auspicherai	attese
auspicherete	attese
auspichiamo	attese
auspicheremmo	attese
auspicanti	attese
auspicasse	attese
auspicherei	attese
auspicai	attese
auspichereste	attese
auspicheresti	attese
auspicherò	attese
auspicarono	attese
auspicammo	attese
auspicando	attese
auspichiate	attese
auspica	attese
auspicata	attese
auspicassimo	attese
auspicavate	attese
auspicavi	attese
auspicavano	attese
auspicate	attese
auspicante	attese
auspichino	attese
auspicherà	attese
auspicare	attese
auspicheranno	attese
auspico	attese
auspicassero	attese
conosceremmo	attese
conoscessi	attese
conosciate	attese
conosceste	attese
conoscerai	attese
conoscessimo	attese
conosco	attese
conoscerei	attese
conoscevo	attese
conobbi	attese
conoscevano	attese
conobbero	attese
conosce	attese
conosceresti	attese
conoscevi	attese
conosciamo	attese
conosciuta	attese
conoscendo	attese
conoscerà	attese
conobbe	attese
conoscesti	attese
conoscerò	attese
conoscerete	attese
conoscessero	attese
conoscevamo	attese
conosci	attese
conoscano	attese
conosceranno	attese
conosceva	attese
conoscono	attese
conosca	attese
conoscerebbero	attese
conoscereste	attese
conoscevate	attese
conoscer	attese
conoscente	attese
conoscenti	attese
conosciuto	attese
conoscerebbe	attese
conosceremo	attese
conoscere	attese
conoscesse	attese
conoscete	attese
conosciuti	attese
conosciute	attese
conoscemmo	attese
emozionerebbero	attese
emozionammo	attese
emozionavamo	attese
emozionerai	attese
emozionava	attese
emozionassi	attese
emozionasti	attese
emozioneremmo	attese
emozionerei	attese
emoziono	attese
emozionerete	attese
emozionata	attese
emozionato	attese
emozionai	attese
emozionanti	attese
emozionavi	attese
emozionerà	attese
emozioneremo	attese
emozionano	attese
emozionerò	attese
emozioni	attese
emozionate	attese
emozioneranno	attese
emozionati	attese
emozionavate	attese
emozionavano	attese
emozionasse	attese
emozionino	attese
emozionante	attese
emozionereste	attese
emozionò	attese
emozionare	attese
emozioniamo	attese
emozionando	attese
emozioneresti	attese
emoziona	attese
emozionassimo	attese
emozionar	attese
emozionavo	attese
emozionassero	attese
emozioniate	attese
emozionarono	attese
emozionaste	attese
emozionerebbe	attese
fiducie	attese
fiducia	attese
incertissimi	attese
incerto	attese
incertaccia	attese
incerte	attese
incertosetta	attese
incerta	attese
incertaccie	attese
incertissima	attese
incertosetti	attese
incertaccio	attese
incertini	attese
incertissimo	attese
incertina	attese
incertissime	attese
incertosette	attese
incertine	attese
incerti	attese
incertino	attese
incertosetto	attese
incertaccii	attese
fiduciosini	attese
fiduciosette	attese
fiduciosaccio	attese
fiduciosissimo	attese
fiduciosaccie	attese
fiduciosetta	attese
fiduciosissima	attese
fiduciosino	attese
fiduciosina	attese
fiduciosine	attese
fiduciosetti	attese
fiduciosaccia	attese
fiduciosissimi	attese
fiduciosi	attese
fiduciosa	attese
fiducioso	attese
fiduciose	attese
fiduciosetto	attese
fiduciosissime	attese
fiduciosaccii	attese
ipotesi	attese
auspicio	attese
speranze	attese
speranza	attese
sognato	attese
sognata	attese
sognati	attese
sognate	attese
profetizzi	attese
profetizzerei	attese
profetizzanti	attese
profetizzassimo	attese
profetizziate	attese
profetizzerebbe	attese
profetizzati	attese
profetizzò	attese
profetizzammo	attese
profetizzava	attese
profetizzassero	attese
profetizziamo	attese
profetizzar	attese
profetizzavo	attese
profetizzerai	attese
profetizzato	attese
profetizzerà	attese
profetizzavamo	attese
profetizzante	attese
profetizzerete	attese
profetizzai	attese
profetizzavate	attese
profetizzando	attese
profetizza	attese
profetizzassi	attese
profetizzasse	attese
profetizzaste	attese
profetizzeremo	attese
profetizzo	attese
profetizzare	attese
profetizzerebbero	attese
profetizzereste	attese
profetizzano	attese
profetizzata	attese
profetizzarono	attese
profetizzeranno	attese
profetizzeremmo	attese
profetizzate	attese
profetizzasti	attese
profetizzerò	attese
profetizzeresti	attese
profetizzino	attese
profetizzavi	attese
profetizzavano	attese
sospirato	attese
sospirata	attese
sospirati	attese
sospirate	attese
pronostico	attese
pronostici	attese
sperando	attese
sperato	attese
speravi	attese
spereranno	attese
sperassimo	attese
sperasse	attese
spererai	attese
sperata	attese
sperar	attese
spereremo	attese
speranti	attese
spereresti	attese
spererete	attese
sperino	attese
speravano	attese
sperare	attese
sperava	attese
speri	attese
speravamo	attese
spererò	attese
speravate	attese
sperò	attese
spererebbe	attese
sperassero	attese
spererà	attese
speravo	attese
spererebbero	attese
sperai	attese
sperarono	attese
spererei	attese
spero	attese
sperammo	attese
sperassi	attese
speraste	attese
sperereste	attese
sperasti	attese
spereremmo	attese
sperati	attese
spera	attese
speriamo	attese
speriate	attese
sperante	attese
sperate	attese
sperano	attese
invocata	attese
invocati	attese
invocate	attese
invocato	attese
supposizione	attese
supposizioni	attese
vorremo	attese
voleste	attese
voluto	attese
vorreste	attese
vuol	attese
vorrebbe	attese
vogliono	attese
volenti	attese
volute	attese
volessero	attese
volendo	attese
vorrebbero	attese
volere	attese
vogliamo	attese
volevamo	attese
volevate	attese
volesse	attese
vorrò	attese
volemmo	attese
vorrei	attese
vorrai	attese
vogliate	attese
volesti	attese
volente	attese
volevo	attese
volevi	attese
voleva	attese
vorrete	attese
volevano	attese
voler	attese
vorrà	attese
voglia	attese
vuoi	attese
vorresti	attese
volete	attese
volessimo	attese
volle	attese
vogliano	attese
volessi	attese
vuole	attese
volli	attese
vorremmo	attese
voluta	attese
voluti	attese
vorranno	attese
voglio	attese
vollero	attese
bramò	attese
brameresti	attese
bramata	attese
bramerei	attese
bramando	attese
bramerai	attese
brameremmo	attese
bramavo	attese
bramaste	attese
bramassero	attese
bramerebbero	attese
bramarono	attese
bramar	attese
bramate	attese
brameranno	attese
bramavi	attese
bramerebbe	attese
brama	attese
brameremo	attese
bramante	attese
bramassi	attese
bramavate	attese
bramerete	attese
bramo	attese
bramati	attese
bramava	attese
bramammo	attese
bramerà	attese
bramavano	attese
bramanti	attese
bramavamo	attese
bramino	attese
bramano	attese
bramai	attese
bramare	attese
bramasse	attese
bramereste	attese
bramerò	attese
bramassimo	attese
brami	attese
bramasti	attese
bramato	attese
anticipazioni	attese
anticipazione	attese
prospettiva	attese
prospettive	attese
attese	attese
attesa	attese
supporrai	attese
supponevate	attese
suppor	attese
supporremmo	attese
suppongano	attese
supponevamo	attese
supporrò	attese
supporrei	attese
supposto	attese
supponemmo	attese
supporreste	attese
supponevano	attese
supporrebbe	attese
supponendo	attese
supposti	attese
suppose	attese
supposero	attese
supponesse	attese
supponesti	attese
supporremo	attese
supporresti	attese
supporrete	attese
supponiamo	attese
supponeste	attese
supponga	attese
supposte	attese
supponiate	attese
supponi	attese
supponente	attese
suppongo	attese
supponessero	attese
supporre	attese
supponenti	attese
supponeva	attese
supponevo	attese
suppongono	attese
supporranno	attese
supponessi	attese
supposta	attese
supponete	attese
suppone	attese
supponessimo	attese
supporrebbero	attese
supporrà	attese
supponevi	attese
supposi	attese